concept:book:new	concept:mutualproxyfor	concept:emotion:love
concept:county:jupiter	concept:proxyfor	concept:city:florida
concept:mammal:domestic_animals	concept:animalpreyson	concept:mammal:dogs
concept:mammal:rabbits	concept:animalistypeofanimal	concept:mammal:animals
concept:city:rocklin	concept:atlocation	concept:stateorprovince:california
concept:householditem:customer	concept:proxyfor	concept:book:new
concept:city:sarasota	concept:proxyfor	concept:city:florida
concept:profession:professions	concept:professionistypeofprofession	concept:profession:pharmacists
concept:monarch:property	concept:agentcollaborateswithagent	concept:person:government
concept:politician:sam_sullivan	concept:worksfor	concept:city:vancouver
concept:stateorprovince:virginia	concept:mutualproxyfor	concept:city:sterling
concept:insect:bugs	concept:animalsuchasinsect	concept:insect:mosquitos
concept:agriculturalproduct:lime	concept:agriculturalproductcookedwithagriculturalproduct	concept:vegetable:pepper
concept:city:perris	concept:proxyfor	concept:stateorprovince:california
concept:reptile:amphibians	concept:animalpreyson	concept:reptile:pets
concept:sportsteam:oilers	concept:teamplaysagainstteam	concept:sportsteam:sd_chargers
concept:musicsong:abilene	concept:mutualproxyfor	concept:city:texas
concept:city:district	concept:cityalsoknownas	concept:city:columbia
concept:book:new	concept:mutualproxyfor	concept:island:selection
concept:sportsteam:bucs	concept:teamplaysagainstteam	concept:sportsteam:dallas_cowboys
concept:emotion:college	concept:mutualproxyfor	concept:book:new
concept:country:estonia	concept:countrylocatedingeopoliticallocation	concept:country:countries
concept:invertebrate:crows	concept:animalistypeofanimal	concept:animal:creatures
concept:boardgame:board	concept:synonymfor	concept:nongovorganization:council
concept:coach:metro_areas	concept:proxyfor	concept:book:new
concept:city:chula_vista	concept:proxyfor	concept:stateorprovince:california
concept:musicalbum:us	concept:synonymfor	concept:politicalparty:republic
concept:stateorprovince:illinois	concept:mutualproxyfor	concept:city:gurnee
concept:mammal:dogs	concept:specializationof	concept:mammal:pets
concept:mammal:animals	concept:animalpreyson	concept:mammal:buffaloes
concept:arthropod:raccoons	concept:animalsuchasinvertebrate	concept:animal:mammals001
concept:city:washington_d_c	concept:subpartof	concept:stateorprovince:district_of_columbia
concept:vegetable:pepper	concept:agriculturalproductcookedwithagriculturalproduct	concept:visualizableobject:tomato_paste
concept:profession:counselors	concept:professionistypeofprofession	concept:profession:psychologists
concept:nongovorganization:senate_republicans	concept:organizationhiredperson	concept:personmexico:ryan_whitney
concept:stateorprovince:states	concept:statelocatedingeopoliticallocation	concept:country:republic_of_india
concept:sportsteam:washington_wizards	concept:teamplaysagainstteam	concept:sportsteam:heat
concept:stateorprovince:california	concept:mutualproxyfor	concept:city:encinitas
concept:agriculturalproduct:cinnamon	concept:agriculturalproductcookedwithagriculturalproduct	concept:vegetable:pepper
concept:insect:bugs	concept:animalthatfeedoninsect	concept:insect:beetles
concept:mammal:rabbits	concept:animalistypeofanimal	concept:animal:herbivores
concept:city:tripoli	concept:citylocatedincountry	concept:country:libya
concept:animal:creatures	concept:animalistypeofanimal	concept:mammal:animals
concept:city:florida	concept:mutualproxyfor	concept:city:st__petersburg
concept:newspaper:the_national	concept:organizationheadquarteredincity	concept:city:washington_d_c
concept:vegetable:pepper	concept:agriculturalproductcookedwithagriculturalproduct	concept:food:grape_tomatoes
concept:personmexico:ryan_whitney	concept:worksfor	concept:country:party
concept:sportsteam:st___louis_cardinals	concept:teamplaysagainstteam	concept:sportsteam:chicago_cubs
concept:sportsteam:kings_college	concept:teamplaysagainstteam	concept:sportsteam:hawks
concept:profession:anesthesiologists	concept:professionistypeofprofession	concept:profession:providers
concept:bedroomitem:experience	concept:mutualproxyfor	concept:book:new
concept:person:spurrier	concept:worksfor	concept:city:florida
concept:geometricshape:queens	concept:proxyfor	concept:company:new_york
concept:mammal:dogs	concept:animalistypeofanimal	concept:animal:babies
concept:profession:practitioners	concept:professionistypeofprofession	concept:profession:psychiatrists
concept:profession:staff	concept:professionistypeofprofession	concept:profession:practitioners
concept:sportsteam:knicks	concept:organizationhiredperson	concept:coach:mike_d_antoni
concept:fruit:oranges	concept:agriculturalproductcookedwithagriculturalproduct	concept:food:peppers
concept:stateorprovince:california	concept:mutualproxyfor	concept:city:santa_ana
concept:city:springfield	concept:atlocation	concept:stateorprovince:ohio
concept:stateorprovince:colorado	concept:organizationhiredperson	concept:coach:gary_barnett
concept:stateorprovince:idaho	concept:stateorprovinceisborderedbystateorprovince	concept:visualizablescene:washington
concept:sportsleague:nfl	concept:leaguestadiums	concept:stadiumoreventvenue:louisiana_superdome
concept:sportsteam:detroit_lions	concept:teamplaysagainstteam	concept:sportsteam:bears_29_17
concept:profession:services	concept:professionistypeofprofession	concept:profession:professions
concept:city:klamath_falls	concept:proxyfor	concept:stateorprovince:oregon
concept:company:usa_today001	concept:competeswith	concept:politicsblog:journal
concept:city:venice	concept:subpartof	concept:stateorprovince:california
concept:date:meeting	concept:atdate	concept:month:june
concept:insect:ticks	concept:animalsuchasinvertebrate	concept:insect:bugs
concept:university:state_university	concept:organizationalsoknownas	concept:stateorprovince:indiana
concept:musicalbum:number_two	concept:mutualproxyfor	concept:book:new
concept:stateorprovince:illinois	concept:mutualproxyfor	concept:county:chicago
concept:chemical:gases	concept:chemicalistypeofchemical	concept:chemical:gas
concept:stateorprovince:indiana	concept:organizationhiredperson	concept:personmexico:ike_davis
concept:stateorprovince:california	concept:mutualproxyfor	concept:city:yreka
concept:mammal:cats	concept:animalpreyson	concept:mammal:mammals
concept:stateorprovince:california	concept:mutualproxyfor	concept:city:san_bernardino
concept:profession:specialists	concept:professionistypeofprofession	concept:profession:researchers
concept:governmentorganization:department	concept:subpartof	concept:stateorprovince:texas
concept:county:south_lake_tahoe	concept:mutualproxyfor	concept:stateorprovince:california
concept:sport:basketball	concept:sportfansincountry	concept:country:__america
concept:city:washington_d_c	concept:mutualproxyfor	concept:county:seattle
concept:sportsteamposition:five	concept:mutualproxyfor	concept:room:community
concept:stateorprovince:oregon	concept:organizationhiredperson	concept:coach:ernie_kent
concept:reptile:lizards	concept:animalistypeofanimal	concept:mammal:pets
concept:mammal:animals	concept:animalpreyson	concept:bird:woodpeckers
concept:city:st__petersburg	concept:locationlocatedwithinlocation	concept:city:florida
concept:county:san_francisco	concept:organizationhiredperson	concept:athlete:mike_singletary
concept:city:pawtucket	concept:proxyfor	concept:stateorprovince:rhode_island
concept:city:lakewood	concept:proxyfor	concept:stateorprovince:colorado
concept:mammal:rabbits	concept:animalpreyson	concept:animal:small_mammals
concept:animal:leopards	concept:animalistypeofanimal	concept:mammal:cats
concept:chemical:compounds	concept:chemicalistypeofchemical	concept:chemical:substances
concept:sportsteam:phils	concept:teamplaysagainstteam	concept:sportsteam:pirates
concept:city:albany	concept:proxyfor	concept:lake:new
concept:city:san_bernardino	concept:subpartof	concept:stateorprovince:california
concept:city:schaumburg	concept:citylocatedinstate	concept:stateorprovince:illinois
concept:sportsteam:pittsburgh_pirates	concept:teamplaysagainstteam	concept:sportsteam:red_sox_this_season
concept:agriculturalproduct:pigs	concept:animalistypeofanimal	concept:animal:creatures
concept:sportsteam:ncaa_youth_kids	concept:agentcompeteswithagent	concept:stateorprovince:oregon
concept:politicianus:richard_m__daley	concept:personbelongstoorganization	concept:county:chicago
concept:beverage:arizona	concept:mutualproxyfor	concept:legume:tempe
concept:profession:professionals	concept:professionistypeofprofession	concept:profession:scientists
concept:agriculturalproduct:salt	concept:agriculturalproductcookedwithagriculturalproduct	concept:vegetable:vinegar
concept:mammal:domestic_animals	concept:animalpreyson	concept:mammal:horses
concept:city:dayton	concept:proxyfor	concept:stateorprovince:ohio
concept:animal:creatures	concept:animalpreyson	concept:mammal:horses
concept:bird:sea_eagles	concept:agentcompeteswithagent	concept:animal:birds002
concept:sportsequipment:goal	concept:proxyfor	concept:book:new
concept:sportsteam:brewers	concept:teamplaysagainstteam	concept:sportsteam:yankees
concept:city:duarte	concept:atlocation	concept:stateorprovince:california
concept:stateorprovince:california	concept:mutualproxyfor	concept:city:covina
concept:writer:brown	concept:persongraduatedschool	concept:university:state_university
concept:city:cape_coral	concept:proxyfor	concept:city:florida
concept:sportsequipment:board	concept:mutualproxyfor	concept:musicartist:federation
concept:book:new	concept:mutualproxyfor	concept:eventoutcome:cost
concept:vegetable:spinach	concept:agriculturalproductcookedwithagriculturalproduct	concept:food:peppers
concept:reptile:pets	concept:animalpreyson	concept:animal:animals002
concept:book:new	concept:mutualproxyfor	concept:room:back
concept:animal:herbivores	concept:animalistypeofanimal	concept:agriculturalproduct:pigs
concept:city:miami_beach	concept:subpartof	concept:city:florida
concept:sportsteam:twins	concept:teamplaysagainstteam	concept:sportsteam:brewers
concept:animal:animals002	concept:animalpreyson	concept:reptile:pets
concept:sportsteam:red_sox	concept:teamplaysagainstteam	concept:sportsteam:tampa_bay_devil_rays
concept:book:new	concept:mutualproxyfor	concept:landscapefeatures:metropolitan_area
concept:profession:professionals	concept:professionistypeofprofession	concept:profession:technicians
concept:sportsteam:oakland_raiders	concept:teamplaysagainstteam	concept:sportsteam:bengals
concept:book:new	concept:mutualproxyfor	concept:emotion:fun
concept:insect:grubs	concept:invertebratefeedonfood	concept:agriculturalproduct:wood
concept:mammal:coyotes	concept:animalpreyson	concept:mammal:animals
concept:stateorprovince:arizona	concept:mutualproxyfor	concept:city:phoenix
concept:profession:spokane	concept:proxyfor	concept:city:washington_d_c
concept:country:orleans	concept:atlocation	concept:lake:new
concept:book:new	concept:subpartof	concept:politicsissue:residents
concept:date:meeting	concept:atdate	concept:month:july
concept:sportsequipment:new	concept:mutualproxyfor	concept:profession:employees
concept:city:members	concept:organizationhiredperson	concept:personmexico:ryan_whitney
concept:lake:new	concept:locationlocatedwithinlocation	concept:country:switzerland
concept:politician:carolyn_goodman	concept:personleadsgeopoliticalorganization	concept:county:las_vegas
concept:agriculturalproduct:plants	concept:agriculturalproducttoattractinsect	concept:insect:bugs
concept:city:washington_d_c	concept:mutualproxyfor	concept:county:bellingham
concept:city:auckland	concept:proxyfor	concept:country:new_zealand
concept:country:__america	concept:countryalsoknownas	concept:country:pacific_islands
concept:politicalparty:college	concept:synonymfor	concept:university:state_university
concept:county:edison	concept:subpartof	concept:radiostation:new_jersey
concept:city:washington_d_c	concept:mutualproxyfor	concept:city:vancouver
concept:stateorprovince:oregon	concept:mutualproxyfor	concept:city:klamath_falls
concept:stateorprovince:states	concept:statelocatedingeopoliticallocation	concept:country:iraq
concept:sportsteam:brazil	concept:proxyfor	concept:stateorprovince:indiana
concept:sportsteam:heat	concept:organizationhiredperson	concept:person:pat_riley
concept:profession:advocates	concept:professionistypeofprofession	concept:profession:nurses
concept:musicsong:abilene	concept:atlocation	concept:city:texas
concept:country:israel	concept:proxyfor	concept:lake:new
concept:city:plano	concept:mutualproxyfor	concept:city:texas
concept:city:florida	concept:mutualproxyfor	concept:city:bradenton
concept:city:petersburg	concept:atlocation	concept:stateorprovince:virginia
concept:mammal:bats	concept:specializationof	concept:mammal:animals
concept:sportsteam:arizona_diamond_backs	concept:teamplaysagainstteam	concept:sportsteam:white_sox
concept:coach:jon_gruden	concept:coachesteam	concept:sportsteam:bucs
concept:mammal:domestic_animals	concept:animalistypeofanimal	concept:mammal:dogs
concept:insect:beetles	concept:animaleatfood	concept:vegetable:leaves
concept:profession:professionals	concept:professionistypeofprofession	concept:jobposition:nurse
concept:stateorprovince:colorado	concept:mutualproxyfor	concept:city:loveland
concept:mammal:pets	concept:animalpreyson	concept:animal:bunnies
concept:city:joliet	concept:subpartof	concept:stateorprovince:illinois
concept:stateorprovince:california	concept:mutualproxyfor	concept:city:concord
concept:city:littleton	concept:locationlocatedwithinlocation	concept:stateorprovince:colorado
concept:animal:small_mammals	concept:animalpreyson	concept:mammal:guinea_pigs
concept:museum:west_palm_beach	concept:locationlocatedwithinlocation	concept:city:florida
concept:agriculturalproduct:blue_cheese	concept:agriculturalproductcookedwithagriculturalproduct	concept:vegetable:pepper
concept:sportsteam:twins	concept:teamplaysagainstteam	concept:sportsteam:chicago_cubs
concept:city:sterling	concept:mutualproxyfor	concept:stateorprovince:virginia
concept:animal:animals002	concept:animalpreyson	concept:animal:llama001
concept:sportsteam:white_sox	concept:teamplaysagainstteam	concept:sportsteam:seattle_mariners
concept:city:birmingham	concept:proxyfor	concept:stateorprovince:alabama
concept:book:new	concept:mutualproxyfor	concept:geometricshape:queens
concept:shoppingmall:palm_beach_gardens	concept:mutualproxyfor	concept:city:florida
concept:profession:practitioners	concept:professionistypeofprofession	concept:profession:general_practitioners
concept:personmexico:ryan_whitney	concept:worksfor	concept:governmentorganization:department
concept:county:plattsburgh	concept:proxyfor	concept:company:new_york
concept:city:washington_d_c	concept:locationlocatedwithinlocation	concept:newspaper:the_national
concept:stateorprovince:louisiana	concept:mutualproxyfor	concept:city:new_orleans
concept:stateorprovince:california	concept:subpartoforganization	concept:sportsteam:ncaa_youth_kids
concept:city:rochelle	concept:atlocation	concept:lake:new
concept:city:naperville	concept:locationlocatedwithinlocation	concept:stateorprovince:illinois
concept:profession:providers	concept:professionistypeofprofession	concept:jobposition:nurse
concept:county:austin	concept:proxyfor	concept:city:texas
concept:agriculturalproduct:cayenne_pepper	concept:agriculturalproductcookedwithagriculturalproduct	concept:vegetable:pepper
concept:reptile:turtles	concept:animalpreyson	concept:mammal:pets
concept:agriculturalproduct:flavor	concept:agriculturalproductcookedwithagriculturalproduct	concept:vegetable:pepper
concept:city:bakersfield	concept:proxyfor	concept:stateorprovince:california
concept:agriculturalproduct:livestock	concept:animalpreyson	concept:mammal:cows
concept:book:leader	concept:mutualproxyfor	concept:book:new
concept:city:seal_beach	concept:atlocation	concept:stateorprovince:california
concept:radiostation:new_jersey	concept:mutualproxyfor	concept:building:atlantic_city
concept:sportsteam:new_york_jets	concept:organizationhiredperson	concept:coach:rex_ryan
concept:country:countries	concept:organizationhiredperson	concept:personmexico:ryan_whitney
concept:sportsteam:cavs	concept:teamplaysagainstteam	concept:sportsteam:heat
concept:aquarium:louis	concept:proxyfor	concept:stateorprovince:indiana
concept:politicaloffice:new	concept:mutualproxyfor	concept:governmentorganization:states_department
concept:stateorprovince:connecticut	concept:subpartof	concept:country:usa
concept:celebrity:safari	concept:agentcollaborateswithagent	concept:politician:jobs
concept:city:denver	concept:organizationhiredperson	concept:coach:shanahan
concept:sportsteam:chicago_cubs	concept:teamplaysagainstteam	concept:sportsteam:phils
concept:city:fremont	concept:proxyfor	concept:stateorprovince:california
concept:country:ghana	concept:countrylocatedingeopoliticallocation	concept:stateorprovince:states
concept:sportsteam:new_jersey_nets	concept:teamplaysagainstteam	concept:sportsteam:pistons
concept:agriculturalproduct:pigs	concept:specializationof	concept:mammal:mals
concept:stateorprovince:web_search	concept:agentcompeteswithagent	concept:university:google
concept:city:ukiah	concept:atlocation	concept:stateorprovince:california
concept:city:santa_clarita	concept:locationlocatedwithinlocation	concept:stateorprovince:california
concept:sportsteam:brazil	concept:teamplaysagainstteam	concept:sportsteam:germany
concept:animal:pet	concept:animalpreyson	concept:mammal:cats
concept:mammal:deer	concept:mammalsuchasmammal	concept:mammal:antelope
concept:person:larry_page	concept:agentcontrols	concept:university:google
concept:reptile:alligators	concept:animalistypeofanimal	concept:animal:creatures
concept:sportsteam:nuggets	concept:teamplaysagainstteam	concept:sportsteam:new_jersey_nets
concept:politicalparty:republic	concept:synonymfor	concept:city:sweden
concept:sportsteam:bucs	concept:teamplaysagainstteam	concept:sportsteam:sd_chargers
concept:coach:kentucky	concept:subpartof	concept:sportsteam:ncaa_youth_kids
concept:sportsteam:spurs	concept:teamplaysagainstteam	concept:sportsteam:knicks
concept:country:ethiopia	concept:countrylocatedingeopoliticallocation	concept:stateorprovince:states
concept:city:palm_springs	concept:subpartof	concept:stateorprovince:california
concept:nongovorganization:gop	concept:organizationhiredperson	concept:personmexico:ryan_whitney
concept:city:decatur	concept:subpartof	concept:stateorprovince:alabama
concept:vehicle:states	concept:subpartof	concept:geopoliticallocation:southwest001
concept:city:gastonia	concept:proxyfor	concept:stateorprovince:north_carolina
concept:agriculturalproduct:salt	concept:agriculturalproductcookedwithagriculturalproduct	concept:vegetable:onion
concept:profession:surgeons	concept:professionistypeofprofession	concept:profession:providers
concept:profession:experts	concept:professionistypeofprofession	concept:profession:nurses
concept:sportsteam:nuggets	concept:teamplaysagainstteam	concept:sportsteam:spurs
concept:sportsteam:red_sox	concept:teamplaysagainstteam	concept:sportsteam:yankees
concept:university:google	concept:organizationterminatedperson	concept:person:larry_page
concept:chemical:gas	concept:chemicalistypeofchemical	concept:chemical:sulphur
concept:politicsblog:more_times	concept:atlocation	concept:lake:new
concept:university:ohio	concept:mutualproxyfor	concept:university:akron
concept:musicalbum:destination	concept:mutualproxyfor	concept:book:new
concept:stateorprovince:georgia	concept:mutualproxyfor	concept:city:norcross
concept:book:new	concept:mutualproxyfor	concept:musicinstrument:stuff
concept:country:__america	concept:locationlocatedwithinlocation	concept:geopoliticallocation:southern
concept:island:iceland	concept:countrylocatedingeopoliticallocation	concept:country:countries
concept:food:peppers	concept:agriculturalproductcookedwithagriculturalproduct	concept:vegetable:tomato
concept:agriculturalproduct:summer_squash	concept:agriculturalproductcookedwithagriculturalproduct	concept:vegetable:pepper
concept:mammal:dogs	concept:specializationof	concept:animal:pack_animals
concept:profession:practitioners	concept:professionistypeofprofession	concept:profession:internists
concept:coach:alabama_crimson_tide	concept:subpartof	concept:sportsteam:ncaa_youth_kids
concept:city:dublin_dublin	concept:mutualproxyfor	concept:stateorprovince:georgia
concept:city:st_louis	concept:proxyfor	concept:stateorprovince:missouri
concept:vehicle:states	concept:atlocation	concept:country:united_states
concept:city:barcelona	concept:proxyfor	concept:country:spain
concept:company:new_york	concept:mutualproxyfor	concept:celebrity:staten_island
concept:politician:jobs	concept:agentcollaborateswithagent	concept:personus:warren_buffet
concept:profession:technicians	concept:professionistypeofprofession	concept:profession:providers
concept:mammal:mammals	concept:animalpreyson	concept:mammal:guinea_pigs
concept:vegetable:pepper	concept:agriculturalproductcookedwithagriculturalproduct	concept:meat:sausage
concept:mlalgorithm:_	concept:mutualproxyfor	concept:book:new
concept:vegetable:potatoes	concept:agriculturalproductcookedwithagriculturalproduct	concept:food:peppers
concept:animal:birds002	concept:animalpreyson	concept:bird:pelicans
concept:monument:philadelphia_area	concept:proxyfor	concept:book:new
concept:room:newport	concept:proxyfor	concept:monument:rhode_island
concept:profession:experts	concept:professionistypeofprofession	concept:profession:lawyers
concept:city:amarillo	concept:citylocatedinstate	concept:stateorprovince:texas
concept:blog:twitter	concept:competeswith	concept:website:facebook
concept:website:washington_times	concept:newspaperincity	concept:city:washington_d_c
concept:island:total	concept:proxyfor	concept:book:new
concept:city:lancaster	concept:proxyfor	concept:stateorprovince:california
concept:vegetable:carrots	concept:agriculturalproductcookedwithagriculturalproduct	concept:food:peppers
concept:book:new	concept:mutualproxyfor	concept:emotion:moment
concept:stateorprovince:california	concept:mutualproxyfor	concept:city:laguna_beach
concept:city:casa_grande	concept:subpartof	concept:stateorprovince:arizona
concept:coach:mike_d_antoni	concept:worksfor	concept:sportsteam:knicks
concept:mammal:domestic_animals	concept:animalistypeofanimal	concept:mammal:horses
concept:bird:chickens	concept:animalistypeofanimal	concept:mammal:pets
concept:visualizablescene:dehli	concept:agentactsinlocation	concept:lake:new
concept:stateorprovince:connecticut	concept:mutualproxyfor	concept:county:new_london
concept:stateorprovince:pensacola	concept:proxyfor	concept:city:florida
concept:sportsteam:michigan_state	concept:synonymfor	concept:university:state_university
concept:mammal:bats	concept:specializationof	concept:mammal:mammals
concept:comedian:oklahoma	concept:subpartof	concept:sportsteam:ncaa_youth_kids
concept:book:new	concept:mutualproxyfor	concept:beverage:arizona
concept:animal:mammals001	concept:animalpreyson	concept:arthropod:raccoons
concept:county:philadelphia	concept:organizationhiredperson	concept:politician:michael_nutter
concept:profession:researchers	concept:professionistypeofprofession	concept:profession:providers
concept:animal:pet	concept:animalpreyson	concept:mammal:dogs
concept:city:ontario	concept:locationlocatedwithinlocation	concept:country:canada_canada
concept:geopoliticallocation:anderson	concept:proxyfor	concept:stateorprovince:indiana
concept:stateorprovince:rhode_island	concept:subpartof	concept:country:usa
concept:profession:providers	concept:professionistypeofprofession	concept:profession:specialists
concept:crustacean:lobsters	concept:animalistypeofanimal	concept:animal:creatures
concept:vegetable:pepper	concept:agriculturalproductcookedwithagriculturalproduct	concept:beverage:lemon_juice
concept:sportsteam:los_angeles_lakers	concept:teamplaysagainstteam	concept:sportsteam:pistons
concept:transportation:residents	concept:mutualproxyfor	concept:book:new
concept:ceo:bernard_l__madoff	concept:topmemberoforganization	concept:company:new_york
concept:city:hampshire	concept:locationlocatedwithinlocation	concept:river:state
concept:fish:salmon	concept:fishservedwithfood	concept:food:eggs
concept:stateorprovince:minnesota	concept:mutualproxyfor	concept:city:duluth
concept:room:properties	concept:mutualproxyfor	concept:book:new
concept:stateorprovince:pennsylvania	concept:mutualproxyfor	concept:city:allentown
concept:profession:providers	concept:professionistypeofprofession	concept:profession:health_care_professionals
concept:agriculturalproduct:cauliflower	concept:agriculturalproductcookedwithagriculturalproduct	concept:vegetable:pepper
concept:mammal:dogs	concept:animalpreyson	concept:mammal:cats
concept:country:new_zealand	concept:mutualproxyfor	concept:city:wellington
concept:sportsteam:pirates	concept:teamalsoknownas	concept:sportsteam:chicago_cubs
concept:sportsteam:ncaa_youth_kids	concept:agentcompeteswithagent	concept:sportsteam:maryland
concept:profession:practitioners	concept:professionistypeofprofession	concept:profession:assistants
concept:profession:specialists	concept:professionistypeofprofession	concept:profession:experts
concept:city:cape_coral	concept:subpartof	concept:city:florida
concept:mammal:rodents	concept:animalpreyson	concept:agriculturalproduct:pigs
concept:agriculturalproduct:dill	concept:agriculturalproductcookedwithagriculturalproduct	concept:vegetable:pepper
concept:city:woodland_hills	concept:atlocation	concept:stateorprovince:california
concept:coach:clemson	concept:agentbelongstoorganization	concept:sportsteam:ncaa_youth_kids
concept:mammal:koala	concept:mammalsuchasmammal	concept:mammal:marsupials
concept:book:years	concept:proxyfor	concept:weatherphenomenon:cape
concept:mammal:pets	concept:animalpreyson	concept:reptile:turtles
concept:profession:education	concept:professionistypeofprofession	concept:profession:professions
concept:stadiumoreventvenue:warfield	concept:atlocation	concept:county:san_francisco
concept:biotechcompany:white	concept:agentcollaborateswithagent	concept:journalist:staff
concept:sportsteam:red_sox_this_season	concept:teamplaysagainstteam	concept:sportsteam:california_angels
concept:sportsteam:oakland_raiders	concept:teamplaysagainstteam	concept:sportsteam:tampa
concept:country:u_s_	concept:countryalsoknownas	concept:country:__america
concept:agriculturalproduct:season	concept:agriculturalproductcookedwithagriculturalproduct	concept:agriculturalproduct:ground_pepper
concept:sportsteam:dodgers	concept:teamplaysagainstteam	concept:sportsteam:chicago_cubs
concept:mammal:mammals	concept:animalpreyson	concept:mammal:cats
concept:sportsteam:ncaa_youth_kids	concept:agentcontrols	concept:personcanada:utah_utes
concept:island:new_york_city_metropolitan_area	concept:subpartof	concept:company:new_york
concept:country:united_states	concept:synonymfor	concept:book:america
concept:profession:physical_therapists	concept:professionistypeofprofession	concept:profession:providers
concept:politicsblog:tribune	concept:organizationheadquarteredincity	concept:city:washington_d_c
concept:mammal:raccoons	concept:animalistypeofanimal	concept:animal:creatures
concept:animal:animals002	concept:animalpreyson	concept:reptile:small_birds
concept:city:kennewick	concept:subpartof	concept:city:washington_d_c
concept:company:new_york	concept:agentactsinlocation	concept:airport:jersey
concept:lake:new	concept:mutualproxyfor	concept:city:u_s__city
concept:politicalparty:republic	concept:synonymfor	concept:country:italy
concept:musicfestival:committee_meetings	concept:mutualproxyfor	concept:sportsequipment:board
concept:city:san_marcos	concept:locationlocatedwithinlocation	concept:stateorprovince:texas
concept:city:kansas	concept:subpartof	concept:country:usa
concept:food:peppers	concept:agriculturalproductcookedwithagriculturalproduct	concept:food:capers
concept:vegetable:spinach	concept:agriculturalproductcookedwithagriculturalproduct	concept:food:tomatoes
concept:beverage:arizona	concept:mutualproxyfor	concept:creditunion:prescott
concept:book:new	concept:proxyfor	concept:sportsgame:short_years
concept:chemical:carbon_dioxide	concept:chemicalistypeofchemical	concept:drug:acid
concept:person:macintosh	concept:agentcollaborateswithagent	concept:politician:jobs
concept:sportsteam:hawks	concept:teamplaysagainstteam	concept:sportsteam:pacers
concept:city:albany	concept:locationlocatedwithinlocation	concept:stateorprovince:georgia
concept:mammal:animals	concept:animalpreyson	concept:mammal:cats
concept:book:brand	concept:mutualproxyfor	concept:book:new
concept:agriculturalproduct:black_pepper	concept:agriculturalproductcookedwithagriculturalproduct	concept:vegetable:onions
concept:city:gilbert	concept:subpartof	concept:beverage:arizona
concept:animal:animals002	concept:animalistypeofanimal	concept:animal:llama001
concept:city:denver	concept:proxyfor	concept:stadiumoreventvenue:fillmore_auditorium
concept:sportsteam:france	concept:teamplaysagainstteam	concept:sportsteam:brazil
concept:vehicle:states	concept:proxyfor	concept:book:new
concept:company:aol	concept:competeswith	concept:blog:google
concept:city:berkeley	concept:atlocation	concept:stateorprovince:california
concept:book:new	concept:mutualproxyfor	concept:book:questions
concept:island:proposal	concept:proxyfor	concept:book:new
concept:politician:jobs	concept:agentcontrols	concept:male:end
concept:mammal:pets	concept:animalistypeofanimal	concept:reptile:iguanas
concept:lake:new	concept:mutualproxyfor	concept:room:offices
concept:vegetable:pepper	concept:agriculturalproductcookedwithagriculturalproduct	concept:agriculturalproduct:pesto
concept:city:el_cajon	concept:subpartof	concept:stateorprovince:california
concept:weatherphenomenon:locations	concept:mutualproxyfor	concept:book:new
concept:agriculturalproduct:livestock	concept:animalistypeofanimal	concept:mammal:pets
concept:profession:providers	concept:professionistypeofprofession	concept:profession:counselors
concept:mammal:animals	concept:animalistypeofanimal	concept:animal:chicks
concept:stateorprovince:indiana	concept:mutualproxyfor	concept:geopoliticallocation:anderson
concept:book:new	concept:proxyfor	concept:sportsgame:consecutive_months
concept:county:tallahassee	concept:agentcollaborateswithagent	concept:politicianus:john_marks
concept:county:columbus	concept:subpartof	concept:stateorprovince:georgia
concept:stateorprovince:pennsylvania	concept:mutualproxyfor	concept:city:pittsburgh
concept:food:eggs	concept:agriculturalproductcomingfromvertebrate	concept:fish:trout
concept:book:new	concept:mutualproxyfor	concept:year:n1978
concept:sportsteam:st___louis_cardinals	concept:teamplaysagainstteam	concept:sportsteam:houston_astros
concept:university:google	concept:agentcompeteswithagent	concept:website:technorati
concept:city:titusville	concept:proxyfor	concept:city:florida
concept:vegetable:pepper	concept:agriculturalproductcookedwithagriculturalproduct	concept:invertebrate:scallops
concept:agriculturalproduct:pigs	concept:animalistypeofanimal	concept:agriculturalproduct:livestock
concept:sportsteam:rams	concept:teamplaysagainstteam	concept:sportsteam:broncos
concept:agriculturalproduct:pigs	concept:animalpreyson	concept:animal:small_mammals
concept:stateorprovince:colorado	concept:subpartoforganization	concept:sportsteam:ncaa_youth_kids
concept:mammal:mammals	concept:animalpreyson	concept:mammal:dogs
concept:animal:bunnies	concept:animalpreyson	concept:mammal:pets
concept:agriculturalproduct:citrus	concept:agriculturalproductcookedwithagriculturalproduct	concept:vegetable:pepper
concept:animal:herbivores	concept:animalistypeofanimal	concept:mammal:deer
concept:beverage:orange_juice	concept:agriculturalproductcookedwithagriculturalproduct	concept:food:peppers
concept:county:san_francisco	concept:atlocation	concept:stateorprovince:california
concept:animal:birds002	concept:animalpreyson	concept:reptile:waterfowl
concept:lake:new	concept:mutualproxyfor	concept:city:denver
concept:beverage:milk	concept:agriculturalproductcookedwithagriculturalproduct	concept:vegetable:pepper
concept:book:new	concept:mutualproxyfor	concept:male:history
concept:county:south_lake_tahoe	concept:atlocation	concept:stateorprovince:california
concept:stateorprovince:california	concept:mutualproxyfor	concept:city:vista
concept:city:urbana	concept:citylocatedinstate	concept:stateorprovince:illinois
concept:company:apple	concept:agentinvolvedwithitem	concept:videogamesystem:ipod
concept:profession:educators	concept:professionistypeofprofession	concept:profession:leaders
concept:agriculturalproduct:figs	concept:agriculturalproductcookedwithagriculturalproduct	concept:vegetable:pepper
concept:food:green_olives	concept:agriculturalproductcookedwithagriculturalproduct	concept:food:peppers
concept:musicalbum:odessa	concept:atlocation	concept:city:texas
concept:stateorprovince:ohio	concept:mutualproxyfor	concept:city:dayton
concept:personmexico:ryan_whitney	concept:worksfor	concept:university:media
concept:city:dallas	concept:organizationhiredperson	concept:coach:bill_walsh
concept:mammal:cats	concept:animalistypeofanimal	concept:mammal:pets
concept:stateorprovince:california	concept:mutualproxyfor	concept:city:glendale
concept:country:russia	concept:countrylocatedingeopoliticallocation	concept:country:countries
concept:city:honolulu	concept:citylocatedinstate	concept:stateorprovince:hawaii
concept:city:lynwood	concept:atlocation	concept:stateorprovince:california
concept:radiostation:san_angelo	concept:mutualproxyfor	concept:city:texas
concept:mammal:mammals	concept:animalistypeofanimal	concept:mammal:rabbits
concept:vegetable:pepper	concept:agriculturalproductcookedwithagriculturalproduct	concept:meat:pork
concept:food:peppers	concept:agriculturalproductcookedwithagriculturalproduct	concept:food:squash
concept:visualizablescene:dehli	concept:atlocation	concept:lake:new
concept:city:sydney	concept:proxyfor	concept:country:australia
concept:eventoutcome:character	concept:proxyfor	concept:book:new
concept:mammal:horses	concept:animalpreyson	concept:animal:creatures
concept:stateorprovince:california	concept:mutualproxyfor	concept:city:auburn
concept:country:new_zealand	concept:mutualproxyfor	concept:lake:new
concept:agriculturalproduct:cayenne_pepper	concept:agriculturalproductcookedwithagriculturalproduct	concept:agriculturalproduct:black_pepper
concept:city:columbia	concept:cityalsoknownas	concept:city:ontario
concept:sportsequipment:new	concept:mutualproxyfor	concept:profession:lawyers
concept:sportsteam:broncos	concept:teamplaysinleague	concept:sportsleague:nfl
concept:stateorprovince:states	concept:statelocatedingeopoliticallocation	concept:country:soviet_union
concept:city:fremont	concept:subpartof	concept:stateorprovince:california
concept:city:petersburg	concept:mutualproxyfor	concept:stateorprovince:virginia
concept:mammal:mals	concept:agentcompeteswithagent	concept:agriculturalproduct:pigs
concept:city:san_rafael	concept:locationlocatedwithinlocation	concept:stateorprovince:california
concept:beverage:hershey	concept:subpartof	concept:stateorprovince:pennsylvania
concept:city:warner_robins	concept:proxyfor	concept:stateorprovince:georgia
concept:beverage:juices	concept:agriculturalproductcookedwithagriculturalproduct	concept:vegetable:pepper
concept:book:new	concept:mutualproxyfor	concept:website:visit
concept:musicalbum:three	concept:mutualproxyfor	concept:sportsequipment:board
concept:agriculturalproduct:herbs	concept:agriculturalproductcookedwithagriculturalproduct	concept:food:peppers
concept:city:team	concept:agentcollaborateswithagent	concept:biotechcompany:white
concept:book:six	concept:mutualproxyfor	concept:city:home
concept:profession:specialists	concept:professionistypeofprofession	concept:profession:psychiatrists
concept:city:redwood_city	concept:proxyfor	concept:stateorprovince:california
concept:sportsteam:ravens	concept:teamplaysagainstteam	concept:sportsteam:rams
concept:stateorprovince:california	concept:mutualproxyfor	concept:city:colton
concept:sportsteam:former_san_francisco_giants	concept:teamplaysagainstteam	concept:sportsteam:chicago_cubs
concept:animal:small_mammals	concept:animalistypeofanimal	concept:agriculturalproduct:pigs
concept:animal:humans	concept:animalistypeofanimal	concept:animal:birds002
concept:sportsteam:nuggets	concept:teamplaysagainstteam	concept:sportsteam:rockets
concept:city:oakland	concept:proxyfor	concept:stateorprovince:california
concept:reptile:cat	concept:animalpreyson	concept:reptile:pets
concept:personmexico:ryan_whitney	concept:worksfor	concept:city:official
concept:ceo:john_o_shea	concept:topmemberoforganization	concept:blog:goal
concept:city:los_osos	concept:atlocation	concept:stateorprovince:california
concept:lake:new	concept:mutualproxyfor	concept:stateorprovince:california
concept:governmentorganization:governments	concept:agentcollaborateswithagent	concept:monarch:property
concept:animal:creatures	concept:animalthatfeedoninsect	concept:insect:ticks
concept:mammal:whales	concept:specializationof	concept:mammal:mammals
concept:profession:specialists	concept:professionistypeofprofession	concept:profession:managers
concept:university:u_t_	concept:mutualproxyfor	concept:city:dallas
concept:weatherphenomenon:two	concept:mutualproxyfor	concept:nongovorganization:council
concept:vegetable:sprouts	concept:agriculturalproductcookedwithagriculturalproduct	concept:vegetable:pepper
concept:city:scranton	concept:subpartof	concept:stateorprovince:pennsylvania
concept:person:meg_whitman	concept:personleadsorganization	concept:company:ebay001
concept:profession:staff	concept:professionistypeofprofession	concept:profession:educators
concept:geometricshape:colleges	concept:mutualproxyfor	concept:book:new
concept:sportsteam:washington_wizards	concept:teamplaysagainstteam	concept:sportsteam:esu_hornets
concept:animal:organisms	concept:animalsuchasinsect	concept:insect:earthworms
concept:mammal:rodents	concept:animalpreyson	concept:mammal:pets
concept:city:washington_d_c	concept:locationlocatedwithinlocation	concept:stateorprovince:international
concept:profession:services	concept:professionistypeofprofession	concept:profession:nurses
concept:vegetable:pepper	concept:agriculturalproductcookedwithagriculturalproduct	concept:agriculturalproduct:broccoli
concept:lake:new	concept:locationlocatedwithinlocation	concept:stateorprovince:california
concept:city:capital	concept:organizationhiredperson	concept:personmexico:ryan_whitney
concept:food:garlic_cloves	concept:agriculturalproductcookedwithagriculturalproduct	concept:vegetable:pepper
concept:food:eggs	concept:agriculturalproductcookedwithagriculturalproduct	concept:vegetable:pepper
concept:city:london_city	concept:proxyfor	concept:lake:new
concept:room:house	concept:mutualproxyfor	concept:filmfestival:eight
concept:person:ichiro_suzuki	concept:personbelongstoorganization	concept:county:seattle
concept:profession:pharmacists	concept:professionistypeofprofession	concept:profession:experts
concept:city:florida	concept:mutualproxyfor	concept:city:fort_walton_beach
concept:geopoliticallocation:anderson	concept:subpartof	concept:stateorprovince:indiana
concept:city:killeen	concept:locationlocatedwithinlocation	concept:stateorprovince:texas
concept:city:lafayette	concept:atlocation	concept:stateorprovince:indiana
concept:profession:counselors	concept:professionistypeofprofession	concept:profession:staff
concept:shoppingmall:delray_beach	concept:subpartof	concept:city:florida
concept:animal:humans	concept:animalpreyson	concept:mammal:dogs
concept:city:yakima	concept:locationlocatedwithinlocation	concept:city:washington_d_c
concept:chemical:particles	concept:chemicalistypeofchemical	concept:chemical:sulphur
concept:profession:chefs	concept:professionistypeofprofession	concept:profession:staff
concept:city:florida	concept:mutualproxyfor	concept:celebrity:venice
concept:sportsteam:chicago_cubs	concept:teamplaysagainstteam	concept:sportsteam:tampa_bay_devil_rays
concept:stateorprovince:virginia	concept:mutualproxyfor	concept:city:danville
concept:politicaloffice:association	concept:mutualproxyfor	concept:professionalorganization:national_board
concept:grain:sugar	concept:agriculturalproductcookedwithagriculturalproduct	concept:vegetable:pepper
concept:city:shanghai	concept:subpartof	concept:country:china
concept:mammal:cats	concept:animalpreyson	concept:mammal:pets
concept:radiostation:topeka	concept:proxyfor	concept:creditunion:kansas
concept:animal:creatures	concept:animalpreyson	concept:mammal:cats
concept:profession:educators	concept:professionistypeofprofession	concept:profession:faculty
concept:city:washington_d_c	concept:mutualproxyfor	concept:county:olympia
concept:vehicle:three	concept:mutualproxyfor	concept:book:new
concept:mammal:mammals	concept:animalpreyson	concept:mammal:monkeys
concept:lake:new	concept:locationlocatedwithinlocation	concept:city:dallas
concept:stateorprovince:california	concept:mutualproxyfor	concept:city:torrance
concept:animal:creatures	concept:animalsuchasinvertebrate	concept:arachnid:ticks
concept:sportsteam:new_jersey_nets	concept:teamplaysagainstteam	concept:sportsteam:hawks
concept:stateorprovince:states	concept:statelocatedingeopoliticallocation	concept:country:jamaica
concept:profession:members	concept:professionistypeofprofession	concept:jobposition:physician
concept:sportsequipment:board	concept:mutualproxyfor	concept:musician:vice_president
concept:building:new_york_area	concept:proxyfor	concept:coach:new
concept:city:tampa_bay	concept:subpartof	concept:city:florida
concept:lake:new	concept:locationlocatedwithinlocation	concept:stadiumoreventvenue:louisiana_superdome
concept:animal:creatures	concept:animalpreyson	concept:animal:hawks
concept:month:june	concept:proxyfor	concept:stateorprovince:illinois
concept:stateorprovince:california	concept:mutualproxyfor	concept:city:victorville
concept:reptile:alligators	concept:animalpreyson	concept:mammal:animals
concept:profession:staff	concept:professionistypeofprofession	concept:profession:psychologists
concept:vegetable:pepper	concept:agriculturalproductcookedwithagriculturalproduct	concept:vegetable:virgin_olive_oil
concept:mammal:cats	concept:animalpreyson	concept:mammal:animals
concept:sportsteam:rockets	concept:teamplaysagainstteam	concept:sportsteam:hawks
concept:sportsteam:bengals	concept:teamplaysagainstteam	concept:sportsteam:new_york_jets
concept:book:new	concept:mutualproxyfor	concept:island:houston
concept:agriculturalproduct:dill	concept:agriculturalproductcookedwithagriculturalproduct	concept:agriculturalproduct:black_pepper
concept:musicalbum:us	concept:synonymfor	concept:book:america
concept:county:utah	concept:mutualproxyfor	concept:biotechcompany:salt_lake_city
concept:university:colorado_state	concept:organizationalsoknownas	concept:university:state_university
concept:coach:kentucky	concept:mutualproxyfor	concept:chemical:paducah
concept:coach:tyrone_willingham	concept:worksfor	concept:city:washington_d_c
concept:lake:new	concept:mutualproxyfor	concept:politicalparty:democrats
concept:newspaper:journal	concept:competeswith	concept:company:cnn_
concept:city:long_beach	concept:proxyfor	concept:stateorprovince:california
concept:terroristorganization:state	concept:agentcollaborateswithagent	concept:terroristorganization:money
concept:sportsteam:montreal_expos	concept:teamplaysagainstteam	concept:sportsteam:chicago_cubs
concept:animal:creatures	concept:animalthatfeedoninsect	concept:insect:earwigs
concept:musicalbum:nine	concept:mutualproxyfor	concept:room:house
concept:stateorprovince:california	concept:mutualproxyfor	concept:city:westminster
concept:bird:ducks	concept:animalistypeofanimal	concept:animal:creatures
concept:county:seattle	concept:proxyfor	concept:city:washington_d_c
concept:mammal:animals	concept:animalpreyson	concept:mammal:giraffes
concept:book:new	concept:mutualproxyfor	concept:book:side
concept:company:apple	concept:organizationterminatedperson	concept:politician:jobs
concept:city:titusville	concept:atlocation	concept:city:florida
concept:sportsteam:bears_29_17	concept:teamplaysagainstteam	concept:sportsteam:broncos
concept:city:woodstock	concept:mutualproxyfor	concept:stateorprovince:georgia
concept:mammal:dogs	concept:mammalsuchasmammal	concept:mammal:bears
concept:sportsteam:gamecocks	concept:organizationhiredperson	concept:coach:steve_spurrier
concept:mammal:whales	concept:animalistypeofanimal	concept:mammal:animals
concept:sportsteam:tampa	concept:teamplaysagainstteam	concept:sportsteam:philadelphia_phillies
concept:politicaloffice:office	concept:synonymfor	concept:governmentorganization:hhs
concept:profession:nurses	concept:professionistypeofprofession	concept:profession:professions
concept:city:santa_rosa	concept:subpartof	concept:stateorprovince:california
concept:profession:librarians	concept:professionistypeofprofession	concept:profession:professionals
concept:sportsteam:bears_29_17	concept:teamplaysagainstteam	concept:sportsteam:jacksonville_jaguars
concept:musicsong:galveston	concept:atlocation	concept:city:texas
concept:person:state	concept:personleadsgeopoliticalorganization	concept:country:left_parties
concept:city:ontario	concept:proxyfor	concept:stateorprovince:california
concept:city:westminster	concept:subpartof	concept:stateorprovince:california
concept:vegetable:pepper	concept:agriculturalproductcookedwithagriculturalproduct	concept:meat:chicken_breast
concept:mammal:animals	concept:animalpreyson	concept:mammal:kangaroos
concept:vertebrate:pet_animals	concept:animalistypeofanimal	concept:mammal:cats
concept:automobilemaker:jeff_bezos	concept:agentcontrols	concept:website:amazon
concept:city:jonesboro	concept:citylocatedinstate	concept:stateorprovince:arkansas
concept:male:history	concept:agentcompeteswithagent	concept:tradeunion:search
concept:ceo:eric_schmidt	concept:proxyfor	concept:university:google
concept:animal:bunnies	concept:animalistypeofanimal	concept:mammal:pets
concept:city:fredericksburg	concept:subpartof	concept:stateorprovince:virginia
concept:animal:creatures	concept:animalpreyson	concept:mammal:dogs
concept:insect:butterflies	concept:animalpreyson	concept:animal:creatures
concept:stateorprovince:indiana	concept:mutualproxyfor	concept:city:elkhart
concept:city:york	concept:subpartof	concept:country:united_states
concept:jobposition:family_physician	concept:professionistypeofprofession	concept:profession:practitioners
concept:city:palo_alto	concept:atlocation	concept:stateorprovince:california
concept:stateorprovince:california	concept:mutualproxyfor	concept:city:citrus_heights
concept:politicaloffice:office	concept:proxyfor	concept:book:new
concept:visualizablescene:dana_point	concept:atlocation	concept:stateorprovince:california
concept:stateorprovince:ohio	concept:subpartof	concept:country:usa
concept:coach:kyle_whittingham	concept:worksfor	concept:county:utah
concept:date:n1977	concept:proxyfor	concept:stateorprovince:california
concept:politicianus:richard_m__daley	concept:personhasresidenceingeopoliticallocation	concept:county:chicago
concept:bank:henderson	concept:subpartof	concept:radiostation:nevada
concept:agriculturalproduct:lemon	concept:agriculturalproductcookedwithagriculturalproduct	concept:vegetable:pepper
concept:profession:psychotherapists	concept:professionistypeofprofession	concept:profession:practitioners
concept:profession:professionals	concept:professionistypeofprofession	concept:profession:facilitators
concept:eventoutcome:story	concept:mutualproxyfor	concept:book:new
concept:governmentorganization:department	concept:synonymfor	concept:university:state_university
concept:emotion:mississippi	concept:mutualproxyfor	concept:recordlabel:tupelo
concept:profession:health_care_professionals	concept:professionistypeofprofession	concept:profession:staff
concept:city:los_banos	concept:proxyfor	concept:stateorprovince:california
concept:city:bellevue	concept:citylocatedingeopoliticallocation	concept:city:washington_d_c
concept:city:texas	concept:mutualproxyfor	concept:person:temple
concept:sportsteam:nc_state	concept:subpartoforganization	concept:sportsteam:ncaa_youth_kids
concept:book:sandy	concept:subpartof	concept:county:utah
concept:sportsteam:red_sox_this_season	concept:teamplaysagainstteam	concept:sportsteam:boston_braves
concept:blog:google	concept:competeswith	concept:company:zoho_office
concept:city:upland	concept:atlocation	concept:stateorprovince:california
concept:mammal:animals	concept:animalistypeofanimal	concept:mammal:dogs
concept:city:florida	concept:mutualproxyfor	concept:city:melbourne
concept:food:eggplant	concept:agriculturalproductcookedwithagriculturalproduct	concept:vegetable:pepper
concept:vegetable:pepper	concept:agriculturalproductcookedwithagriculturalproduct	concept:food:fennel
concept:profession:lawyers	concept:proxyfor	concept:book:new
concept:food:peppers	concept:agriculturalproductcookedwithagriculturalproduct	concept:food:tomatoes
concept:mammal:bear	concept:mammalsuchasmammal	concept:mammal:beaver
concept:stateorprovince:indiana	concept:synonymfor	concept:university:state_university
concept:university:stony_brook	concept:proxyfor	concept:company:new_york
concept:shoppingmall:pompano_beach	concept:mutualproxyfor	concept:city:florida
concept:sportsteam:los_angeles_lakers	concept:teamplaysagainstteam	concept:sportsteam:cavs
concept:coach:places	concept:proxyfor	concept:book:new
concept:city:washington_d_c	concept:proxyfor	concept:stateorprovince:indiana
concept:reptile:fishes	concept:animalistypeofanimal	concept:animal:creatures
concept:stateorprovince:california	concept:mutualproxyfor	concept:city:monrovia
concept:blog:google	concept:competeswith	concept:company:msn
concept:sportsteam:st___louis_cardinals	concept:teamplaysagainstteam	concept:sportsteam:arizona_diamond_backs
concept:geopoliticallocation:dakota	concept:proxyfor	concept:lake:new
concept:politician:jobs	concept:proxyfor	concept:company:pixar
concept:animal:creatures	concept:animalpreyson	concept:animal:birds002
concept:animal:babies	concept:animalistypeofanimal	concept:mammal:animals
concept:stateorprovince:georgia	concept:mutualproxyfor	concept:city:cumming
concept:reptile:cat	concept:animalistypeofanimal	concept:reptile:pets
concept:mammal:animals	concept:animalistypeofanimal	concept:mammal:cows
concept:geopoliticallocation:agencies	concept:organizationhiredperson	concept:personmexico:ryan_whitney
concept:city:service	concept:atlocation	concept:aquarium:u__s_
concept:city:yakima	concept:proxyfor	concept:city:washington_d_c
concept:coach:south_carolina_gamecocks	concept:agentcollaborateswithagent	concept:sportsteam:ncaa_youth_kids
concept:sportsteam:yankees	concept:teamplaysagainstteam	concept:sportsteam:padres
concept:radiostation:san_antonio	concept:mutualproxyfor	concept:city:texas
concept:politicaloffice:association	concept:mutualproxyfor	concept:book:new
concept:politician:jobs	concept:agentcontrols	concept:ceo:richard
concept:profession:experts	concept:professionistypeofprofession	concept:profession:psychologists
concept:book:new	concept:mutualproxyfor	concept:room:theme
concept:personus:warren_buffet	concept:personleadsorganization	concept:nongovorganization:u_s_
concept:park:borough	concept:proxyfor	concept:lake:new
concept:female:yankees	concept:agentcompeteswithagent	concept:university:boston_red_sox
concept:city:flagstaff	concept:atlocation	concept:stateorprovince:arizona
concept:programminglanguage:the_new	concept:atlocation	concept:city:boston
concept:county:san_francisco	concept:proxyfor	concept:stateorprovince:california
concept:university:national	concept:agentactsinlocation	concept:stateorprovince:pensacola
concept:mammal:primates	concept:animalistypeofanimal	concept:mammal:animals
concept:city:san_leandro	concept:mutualproxyfor	concept:stateorprovince:california
concept:book:new	concept:mutualproxyfor	concept:book:nation
concept:city:caledonia	concept:agentactsinlocation	concept:lake:new
concept:sportsteam:red_sox	concept:teamplaysagainstteam	concept:sportsteam:philadelphia_phillies
concept:mammal:hares	concept:animalistypeofanimal	concept:animal:small_mammals
concept:mammal:animals	concept:animalpreyson	concept:mammal:calves
concept:book:new	concept:proxyfor	concept:profession:hours
concept:sportsteam:bears_29_17	concept:teamplaysagainstteam	concept:sportsteam:houston_texans
concept:beach:massachusetts	concept:mutualproxyfor	concept:winery:framingham
concept:room:south	concept:mutualproxyfor	concept:county:philadelphia
concept:year:n1992	concept:mutualproxyfor	concept:book:new
concept:book:new	concept:mutualproxyfor	concept:book:quarter
concept:ceo:eric_schmidt	concept:personleadsorganization	concept:university:google
concept:landscapefeatures:stores	concept:proxyfor	concept:book:new
concept:sportsteam:knicks	concept:teamplaysagainstteam	concept:sportsteam:cavs
concept:city:blythe	concept:proxyfor	concept:stateorprovince:california
concept:county:philadelphia	concept:locationlocatedwithinlocation	concept:county:temple_university
concept:coach:norv_turner	concept:worksfor	concept:sportsteam:sd_chargers
concept:sportsteam:dodgers	concept:teamplaysagainstteam	concept:sportsteam:st___louis_cardinals
concept:profession:professionals	concept:professionistypeofprofession	concept:profession:educators
concept:lake:new	concept:mutualproxyfor	concept:month:october
concept:meat:beef	concept:agriculturalproductcookedwithagriculturalproduct	concept:vegetable:potatoes
concept:book:new	concept:mutualproxyfor	concept:website:breeze
concept:city:newport_beach	concept:proxyfor	concept:stateorprovince:california
concept:sportsteam:dallas_mavericks	concept:teamplaysagainstteam	concept:sportsteam:los_angeles_lakers
concept:country:france_france	concept:countrylocatedingeopoliticallocation	concept:stateorprovince:states
concept:politician:jobs	concept:worksfor	concept:company:imac
concept:sportsteam:minnesota_twins	concept:teamplaysagainstteam	concept:sportsteam:yankees
concept:profession:support_staff	concept:professionistypeofprofession	concept:profession:nurses
concept:governmentorganization:bureau	concept:organizationalsoknownas	concept:governmentorganization:us_department
concept:personmexico:ryan_whitney	concept:personleadsorganization	concept:nongovorganization:senate_judiciary_committee
concept:country:south_africa	concept:countrylocatedingeopoliticallocation	concept:stateorprovince:states
concept:politicsbill:state_law	concept:mutualproxyfor	concept:politicaloffice:new
concept:city:carlsbad	concept:mutualproxyfor	concept:stateorprovince:california
concept:vegetable:pepper	concept:agriculturalproductcookedwithagriculturalproduct	concept:food:artichokes
concept:city:sterling	concept:subpartof	concept:stateorprovince:virginia
concept:mammal:pets	concept:animalistypeofanimal	concept:bird:chickens
concept:university:central	concept:atlocation	concept:continent:africa
concept:reptile:amphibians	concept:animalistypeofanimal	concept:reptile:pets
concept:city:springfield	concept:proxyfor	concept:tableitem:old
concept:county:orange_county	concept:locationlocatedwithinlocation	concept:stateorprovince:california
concept:company:new_york	concept:organizationhiredperson	concept:coach:mangini
concept:sportsequipment:board	concept:mutualproxyfor	concept:governmentorganization:red_cross
concept:stateorprovince:california	concept:mutualproxyfor	concept:city:placentia
concept:lake:new	concept:mutualproxyfor	concept:country:australia
concept:sportsteam:new_york_jets	concept:teamplaysagainstteam	concept:sportsteam:bears_29_17
concept:profession:mediators	concept:professionistypeofprofession	concept:profession:attorneys
concept:insect:ticks	concept:arthropodandotherarthropod	concept:insect:bugs
concept:reptile:pets	concept:animalpreyson	concept:reptile:amphibians
concept:weatherphenomenon:cape	concept:proxyfor	concept:book:years
concept:chemical:chemicals	concept:chemicalistypeofchemical	concept:chemical:compounds
concept:city:springfield	concept:atlocation	concept:stateorprovince:virginia
concept:city:conroe	concept:subpartof	concept:stateorprovince:texas
concept:county:york_county	concept:agentactsinlocation	concept:lake:new
concept:coach:arkansas_razorbacks	concept:agentcollaborateswithagent	concept:sportsteam:ncaa_youth_kids
concept:profession:providers	concept:professionistypeofprofession	concept:profession:educators
concept:city:florida	concept:subpartof	concept:country:usa
concept:stateorprovince:california	concept:mutualproxyfor	concept:city:venice
concept:mountain:inspiration	concept:proxyfor	concept:book:new
concept:boardgame:board	concept:synonymfor	concept:director:committee
concept:beach:fort_worth	concept:locationlocatedwithinlocation	concept:city:texas
concept:geopoliticalorganization:northern	concept:atlocation	concept:stateorprovince:virginia
concept:animal:creatures	concept:animalthatfeedoninsect	concept:insect:earthworms
concept:city:washington_d_c	concept:mutualproxyfor	concept:profession:spokane
concept:stateorprovince:california	concept:mutualproxyfor	concept:city:downey
concept:stateorprovince:colorado	concept:mutualproxyfor	concept:lake:new
concept:televisionshow:providence	concept:mutualproxyfor	concept:monument:rhode_island
concept:wallitem:works	concept:mutualproxyfor	concept:book:new
concept:stateorprovince:indiana	concept:organizationterminatedperson	concept:coach:bill_lynch
concept:city:washington_d_c	concept:mutualproxyfor	concept:city:federal_way
concept:mammal:cats	concept:mammalsuchasmammal	concept:mammal:bear
concept:university:state_university	concept:synonymfor	concept:emotion:northwestern
concept:city:service	concept:organizationacronymhasname	concept:governmentorganization:united_states_department
concept:city:elkhart	concept:proxyfor	concept:stateorprovince:indiana
concept:lake:new	concept:locationlocatedwithinlocation	concept:country:korea
concept:city:melbourne	concept:subpartof	concept:city:florida
concept:mammal:animals	concept:animalpreyson	concept:bird:penguins
concept:sportsteam:red_sox	concept:teamplaysagainstteam	concept:sportsteam:st___louis_cardinals
concept:coach:michigan_state_spartans	concept:subpartof	concept:sportsteam:ncaa_youth_kids
concept:city:northridge	concept:proxyfor	concept:stateorprovince:california
concept:sportsteam:knicks	concept:teamplaysagainstteam	concept:sportsteam:pacers
concept:mammal:animals	concept:animalistypeofanimal	concept:mammal:giraffes
concept:animal:creatures	concept:animalpreyson	concept:mammal:animals
concept:mammal:animals	concept:animalistypeofanimal	concept:reptile:iguanas
concept:insect:caterpillars	concept:animaleatfood	concept:agriculturalproduct:plants
concept:personmexico:isaiah_thomas	concept:worksfor	concept:sportsteam:knicks
concept:city:gurnee	concept:subpartof	concept:stateorprovince:illinois
concept:city:deerfield_beach	concept:proxyfor	concept:city:florida
concept:musicalbum:seasons	concept:mutualproxyfor	concept:book:new
concept:book:new	concept:mutualproxyfor	concept:emotion:son
concept:stateorprovince:virginia	concept:mutualproxyfor	concept:city:fredericksburg
concept:city:roseville	concept:atlocation	concept:stateorprovince:minnesota
concept:city:gardena	concept:mutualproxyfor	concept:stateorprovince:california
concept:city:herald	concept:agentactsinlocation	concept:city:washington_d_c
concept:city:merced	concept:proxyfor	concept:stateorprovince:california
concept:city:burlingame	concept:mutualproxyfor	concept:stateorprovince:california
concept:city:washington_dc	concept:citylocatedingeopoliticallocation	concept:country:us
concept:lake:new	concept:mutualproxyfor	concept:month:november
concept:profession:practitioners	concept:professionistypeofprofession	concept:profession:individuals
concept:sportsteam:bears_29_17	concept:teamplaysagainstteam	concept:sportsteam:ravens
concept:company:apple	concept:mutualproxyfor	concept:politician:jobs
concept:sportsteam:rockets	concept:teamplaysagainstteam	concept:sportsteam:orlando_magic
concept:bird:ducks	concept:animalistypeofanimal	concept:mammal:animals
concept:city:portsmouth	concept:proxyfor	concept:stateorprovince:ohio
concept:profession:specialists	concept:professionistypeofprofession	concept:jobposition:physician
concept:stateorprovince:california	concept:mutualproxyfor	concept:city:ukiah
concept:politician:jobs	concept:personborninlocation	concept:city:york
concept:vegetable:pepper	concept:agriculturalproductcookedwithagriculturalproduct	concept:vegetable:carrot
concept:country:denmark	concept:countrylocatedingeopoliticallocation	concept:country:countries
concept:geopoliticallocation:iraq	concept:organizationhiredperson	concept:personmexico:ryan_whitney
concept:biotechcompany:white	concept:agentcollaborateswithagent	concept:tradeunion:congress
concept:academicfield:lubbock	concept:proxyfor	concept:female:texas_tech_university
concept:musicalbum:two_years	concept:mutualproxyfor	concept:book:new
concept:city:redmond	concept:locationlocatedwithinlocation	concept:city:washington_d_c
concept:sportsteam:red_sox_this_season	concept:teamplaysagainstteam	concept:sportsteam:white_sox
concept:food:peppers	concept:agriculturalproductcookedwithagriculturalproduct	concept:agriculturalproduct:mozzarella
concept:vegetable:pepper	concept:agriculturalproductcookedwithagriculturalproduct	concept:vegetable:onion
concept:election:justice_department	concept:synonymfor	concept:politicaloffice:office
concept:book:new	concept:atlocation	concept:island:society
concept:food:peppers	concept:agriculturalproductcookedwithagriculturalproduct	concept:vegetable:carrot
concept:sportsteam:florida_international	concept:teamplaysagainstteam	concept:sportsteam:sd_chargers
concept:chemical:carbon_dioxide	concept:chemicalistypeofchemical	concept:chemical:gas
concept:person:molly_moore	concept:worksfor	concept:city:washington_d_c
concept:newspaper:journal	concept:competeswith	concept:website:associated_press
concept:profession:individuals	concept:professionistypeofprofession	concept:profession:technicians
concept:sportsteam:rockets	concept:teamplaysagainstteam	concept:sportsteam:spurs
concept:island:scott	concept:mutualproxyfor	concept:book:new
concept:stateorprovince:states	concept:statelocatedingeopoliticallocation	concept:stateorprovince:eu
concept:animal:exotics001	concept:animalpreyson	concept:agriculturalproduct:pigs
concept:profession:practitioners	concept:professionistypeofprofession	concept:jobposition:nurse
concept:stateorprovince:states	concept:stateorprovinceisborderedbystateorprovince	concept:stateorprovince:southeast_asia
concept:vegetable:pepper	concept:agriculturalproductcookedwithagriculturalproduct	concept:agriculturalproduct:peanut_butter
concept:profession:scientists	concept:professionistypeofprofession	concept:profession:experts
concept:stateorprovince:california	concept:mutualproxyfor	concept:shoppingmall:rialto
concept:food:chillies	concept:agriculturalproductcookedwithagriculturalproduct	concept:vegetable:pepper
concept:celebrity:southern_illinois_salukis	concept:subpartof	concept:sportsteam:ncaa_youth_kids
concept:musicalbum:life	concept:mutualproxyfor	concept:book:new
concept:country:thailand	concept:locationlocatedwithinlocation	concept:continent:asia
concept:geometricshape:property	concept:mutualproxyfor	concept:weatherphenomenon:two
concept:profession:researchers	concept:professionistypeofprofession	concept:profession:professionals
concept:city:susanville	concept:proxyfor	concept:stateorprovince:california
concept:city:aspen	concept:citylocatedinstate	concept:stateorprovince:colorado
concept:personmexico:ryan_whitney	concept:worksfor	concept:governmentorganization:justice_department
concept:stateorprovince:california	concept:mutualproxyfor	concept:visualizablescene:dana_point
concept:mammal:pets	concept:animalistypeofanimal	concept:animal:creatures
concept:sportsteam:arizona_diamond_backs	concept:teamplaysagainstteam	concept:sportsteam:colorado_rockies
concept:animal:creatures	concept:animalpreyson	concept:reptile:snakes
concept:profession:librarians	concept:professionistypeofprofession	concept:profession:staff
concept:mammal:bears	concept:animalistypeofanimal	concept:animal:beasts
concept:vegetable:onion	concept:agriculturalproductcookedwithagriculturalproduct	concept:vegetable:carrots
concept:airport:europe	concept:synonymfor	concept:politicalparty:republic
concept:city:normal	concept:subpartof	concept:stateorprovince:illinois
concept:stateorprovince:california	concept:mutualproxyfor	concept:geopoliticallocation:santa_maria
concept:politicsblog:republic	concept:synonymfor	concept:biotechcompany:china
concept:mammal:household_pets	concept:animalpreyson	concept:mammal:animals
concept:city:newark	concept:mutualproxyfor	concept:stateorprovince:california
concept:city:area	concept:proxyfor	concept:book:north
concept:city:yreka	concept:mutualproxyfor	concept:stateorprovince:california
concept:company:new_york	concept:proxyfor	concept:hospital:suny
concept:creditunion:kansas	concept:mutualproxyfor	concept:musicsong:salina
concept:university:ohio	concept:organizationhiredperson	concept:coach:frank_solich
concept:county:philadelphia	concept:locationlocatedwithinlocation	concept:stateorprovince:pennsylvania
concept:agriculturalproduct:bean_sprouts	concept:agriculturalproductcookedwithagriculturalproduct	concept:vegetable:pepper
concept:governmentorganization:doj	concept:synonymfor	concept:politicaloffice:office
concept:city:mcallen	concept:locationlocatedwithinlocation	concept:stateorprovince:texas
concept:sportsteam:oklahoma_sooners_basketball	concept:teamplaysagainstteam	concept:sportsteam:florida_gators
concept:county:olympia	concept:locationlocatedwithinlocation	concept:city:washington_d_c
concept:geopoliticallocation:national	concept:atlocation	concept:geopoliticallocation:grand_junction
concept:meat:chicken_breast	concept:agriculturalproductcookedwithagriculturalproduct	concept:agriculturalproduct:spices
concept:visualizablething:altamonte_springs	concept:atlocation	concept:city:florida
concept:company:los_angeles	concept:proxyfor	concept:coach:new
concept:vegetable:pepper	concept:agriculturalproductcookedwithagriculturalproduct	concept:fruit:oranges
concept:city:london_city	concept:organizationhiredperson	concept:politicianus:ken_livingstone
concept:profession:faculty	concept:professionistypeofprofession	concept:profession:individuals
concept:county:brandon	concept:atlocation	concept:city:florida
concept:agriculturalproduct:cumin	concept:agriculturalproductcookedwithagriculturalproduct	concept:vegetable:pepper
concept:tradeunion:article	concept:agentcompeteswithagent	concept:musicartist:television
concept:blog:google	concept:competeswith	concept:website:yahoo
concept:geometricshape:landscape	concept:mutualproxyfor	concept:book:new
concept:city:palo_alto	concept:proxyfor	concept:stateorprovince:california
concept:county:new_london	concept:subpartof	concept:stateorprovince:connecticut
concept:profession:professionals	concept:professionistypeofprofession	concept:profession:practitioners
concept:sportsteam:los_angeles_dodgers	concept:teamplaysagainstteam	concept:sportsteam:philadelphia_phillies
concept:city:adelaide	concept:citylocatedincountry	concept:country:australia
concept:city:texas	concept:mutualproxyfor	concept:city:lewisville
concept:sportsteam:red_sox	concept:teamplaysagainstteam	concept:sportsteam:red_sox_this_season
concept:building:ohio_state	concept:synonymfor	concept:university:state_university
concept:animal:small_mammals	concept:animalpreyson	concept:mammal:rabbits
concept:stateorprovince:states	concept:statelocatedingeopoliticallocation	concept:country:arabia_saudita
concept:city:hawthorne	concept:mutualproxyfor	concept:stateorprovince:california
concept:newspaper:journal	concept:agentcontrols	concept:website:washington_post
concept:reptile:waterfowl	concept:animalistypeofanimal	concept:animal:animals002
concept:animal:beasts	concept:animalpreyson	concept:mammal:deer
concept:city:westminster	concept:atlocation	concept:stateorprovince:colorado
concept:animal:organisms	concept:animalpreyson	concept:invertebrate:worms
concept:emotion:favourite	concept:proxyfor	concept:book:new
concept:website:change	concept:organizationhiredperson	concept:personmexico:ryan_whitney
concept:stateorprovince:california	concept:mutualproxyfor	concept:city:fallbrook
concept:stadiumoreventvenue:u_s__cellular_arena	concept:atlocation	concept:county:chicago
concept:profession:staff	concept:professionistypeofprofession	concept:profession:photographers
concept:chemical:gases	concept:chemicalistypeofchemical	concept:chemical:substances
concept:bird:pigeons	concept:animalistypeofanimal	concept:mammal:animals
concept:sportsteam:new_york_jets	concept:teamplaysagainstteam	concept:sportsteam:sd_chargers
concept:city:hutchinson	concept:subpartof	concept:stateorprovince:kansas
concept:personmexico:ryan_whitney	concept:worksfor	concept:terroristorganization:group
concept:company:new_york	concept:agentactsinlocation	concept:lake:new
concept:profession:practitioners	concept:professionistypeofprofession	concept:profession:specialists
concept:animal:creatures	concept:animalthatfeedoninsect	concept:insect:mites
concept:sportsequipment:board	concept:mutualproxyfor	concept:book:network
concept:beverage:arizona	concept:mutualproxyfor	concept:coach:chandler
concept:mammal:pets	concept:animalpreyson	concept:mammal:cats
concept:country:norway	concept:countrylocatedingeopoliticallocation	concept:country:countries
concept:mammal:animals	concept:animalpreyson	concept:amphibian:toads
concept:city:florida	concept:mutualproxyfor	concept:shoppingmall:palm_beach_gardens
concept:city:springfield	concept:subpartof	concept:stateorprovince:virginia
concept:insect:fleas	concept:animalsuchasinsect	concept:insect:bugs
concept:visualizablescene:white_plains	concept:proxyfor	concept:lake:new
concept:company:nyt	concept:competeswith	concept:politicsblog:journal
concept:city:decatur	concept:proxyfor	concept:stateorprovince:indiana
concept:country:hungary	concept:countrylocatedingeopoliticallocation	concept:country:countries
concept:mammal:cats	concept:animalistypeofanimal	concept:mammal:domestic_animals
concept:geometricshape:addition	concept:proxyfor	concept:book:new
concept:vegetable:potatoes	concept:agriculturalproductcookedwithagriculturalproduct	concept:agriculturalproduct:spices
concept:book:new	concept:mutualproxyfor	concept:island:the_bronx
concept:university:google	concept:agentcompeteswithagent	concept:website:yahoo_sponsored_search
concept:musicinstrument:station	concept:mutualproxyfor	concept:book:new
concept:profession:dietitians	concept:professionistypeofprofession	concept:profession:professionals
concept:profession:therapists	concept:professionistypeofprofession	concept:profession:health_care_professionals
concept:male:dave_wannstedt	concept:worksfor	concept:sportsteam:florida_international
concept:vehicle:flight	concept:mutualproxyfor	concept:book:new
concept:stateorprovince:california	concept:mutualproxyfor	concept:city:bellflower
concept:insect:ticks	concept:animalsuchasinsect	concept:insect:bugs
concept:company:observer001	concept:organizationheadquarteredincity	concept:city:washington_d_c
concept:vegetable:pepper	concept:agriculturalproductcookedwithagriculturalproduct	concept:agriculturalproduct:pine_nuts
concept:profession:professionals	concept:professionistypeofprofession	concept:profession:primary_care_physicians
concept:county:sacramento	concept:atlocation	concept:stateorprovince:california
concept:mammal:seals	concept:animalpreyson	concept:animal:creatures
concept:city:team	concept:organizationhiredperson	concept:coach:bruce_arena
concept:stateorprovince:california	concept:mutualproxyfor	concept:city:glendora
concept:profession:staff	concept:professionistypeofprofession	concept:profession:craftsmen
concept:hotel:old	concept:locationlocatedwithinlocation	concept:city:springfield
concept:city:hackensack	concept:proxyfor	concept:stateorprovince:new_jersey
concept:sportsteam:nuggets	concept:teamplaysagainstteam	concept:sportsteam:pistons
concept:sportsteam:philadelphia_flyers	concept:teamplaysagainstteam	concept:sportsteam:buffalo_sabres
concept:newspaper:journal	concept:competeswith	concept:website:chicago_tribune
concept:year:n1982	concept:proxyfor	concept:lake:new
concept:vegetable:pepper	concept:agriculturalproductcookedwithagriculturalproduct	concept:vegetable:red_onion
concept:profession:staff	concept:professionistypeofprofession	concept:profession:leaders
concept:profession:nurses	concept:professionistypeofprofession	concept:profession:specialists
concept:month:february	concept:proxyfor	concept:lake:new
concept:sportsteam:new_york_jets	concept:teamplaysagainstteam	concept:sportsteam:oakland_raiders
concept:mammal:animals	concept:animalistypeofanimal	concept:mammal:rodents
concept:city:elkhart	concept:subpartof	concept:stateorprovince:indiana
concept:city:meriden	concept:subpartof	concept:stateorprovince:connecticut
concept:animal:animals002	concept:animalpreyson	concept:reptile:cat
concept:building:hollywood	concept:proxyfor	concept:city:florida
concept:bird:wild_birds	concept:animalpreyson	concept:animal:birds002
concept:food:peppers	concept:agriculturalproductcookedwithagriculturalproduct	concept:vegetable:red_onion
concept:stateorprovince:california	concept:mutualproxyfor	concept:city:palm_desert
concept:sportsteam:padres	concept:teamplaysagainstteam	concept:sportsteam:former_san_francisco_giants
concept:stateorprovince:colorado	concept:mutualproxyfor	concept:city:denver
concept:city:decatur	concept:proxyfor	concept:stateorprovince:georgia
concept:vegetable:pepper	concept:agriculturalproductcookedwithagriculturalproduct	concept:agriculturalproduct:grill
concept:university:akron	concept:subpartof	concept:university:ohio
concept:country:us	concept:countryalsoknownas	concept:country:__america
concept:profession:providers	concept:professionistypeofprofession	concept:profession:nurses
concept:sportsteam:philadelphia_phillies	concept:teamplaysagainstteam	concept:sportsteam:red_sox_this_season
concept:person:john003	concept:persongraduatedschool	concept:university:state_university
concept:building:glendale	concept:proxyfor	concept:beverage:arizona
concept:nongovorganization:u_s_	concept:mutualproxyfor	concept:sportsequipment:new
concept:attraction:victoria001	concept:atlocation	concept:city:texas
concept:mammal:mammals	concept:animalpreyson	concept:agriculturalproduct:pigs
concept:animal:mammals001	concept:animalpreyson	concept:animal:organisms
concept:city:mendocino	concept:atlocation	concept:stateorprovince:california
concept:visualizablescene:agoura_hills	concept:locationlocatedwithinlocation	concept:stateorprovince:california
concept:city:lakeland	concept:subpartof	concept:city:florida
concept:person:home001	concept:worksfor	concept:university:google
concept:university:utah_state	concept:synonymfor	concept:university:state_university
concept:city:azerbaijan	concept:citylocatedincountry	concept:country:azerbaijan
concept:stateorprovince:states	concept:stateorprovinceisborderedbystateorprovince	concept:stateorprovince:mississippi
concept:lake:new	concept:locationlocatedwithinlocation	concept:city:u_s__city
concept:city:lafayette	concept:subpartof	concept:stateorprovince:indiana
concept:city:auckland	concept:citylocatedingeopoliticallocation	concept:country:new_zealand
concept:animal:creatures	concept:animalpreyson	concept:reptile:alligators
concept:profession:authors	concept:professionistypeofprofession	concept:profession:professionals
concept:book:new	concept:mutualproxyfor	concept:weatherphenomenon:coastlines
concept:city:boston	concept:agentactsinlocation	concept:lake:new
concept:sportsteam:rockets	concept:teamplaysagainstteam	concept:sportsteam:kings_college
concept:politicaloffice:new	concept:mutualproxyfor	concept:governmentorganization:state_courts
concept:radiostation:newark	concept:subpartof	concept:university:ohio
concept:bird:buzzard	concept:agentcompeteswithagent	concept:animal:birds002
concept:sportsteam:former_san_francisco_giants	concept:teamplaysagainstteam	concept:sportsteam:dodgers
concept:profession:individuals	concept:professionistypeofprofession	concept:profession:nurses
concept:agriculturalproduct:pigs	concept:agentcompeteswithagent	concept:mammal:mals
concept:male:google_news	concept:agentcompeteswithagent	concept:tradeunion:search
concept:animal:humans	concept:animalistypeofanimal	concept:mammal:primates
concept:mammal:animals	concept:animalpreyson	concept:agriculturalproduct:pigs
concept:emotion:expert	concept:mutualproxyfor	concept:book:new
concept:mlarea:lack	concept:proxyfor	concept:book:new
concept:city:bellevue	concept:proxyfor	concept:city:washington_d_c
concept:sportsteam:ncaa_youth_kids	concept:agentcompeteswithagent	concept:sportsteam:ncaa_mens_midwest_regionals
concept:university:state_university	concept:organizationalsoknownas	concept:university:pennsylvania_state
concept:vegetable:pepper	concept:agriculturalproductcookedwithagriculturalproduct	concept:agriculturalproduct:black_beans
concept:beach:massachusetts	concept:mutualproxyfor	concept:city:amherst
concept:sportsteam:kings_college	concept:teamplaysagainstteam	concept:sportsteam:lee_flames
concept:city:san_clemente	concept:locationlocatedwithinlocation	concept:stateorprovince:california
concept:city:arlington	concept:citylocatedinstate	concept:stateorprovince:virginia
concept:sportsteam:padres	concept:teamplaysagainstteam	concept:sportsteam:brewers
concept:company:weekly_standard001	concept:competeswith	concept:politicsblog:journal
concept:city:johnstown	concept:subpartof	concept:stateorprovince:pennsylvania
concept:food:peppers	concept:agriculturalproductcookedwithagriculturalproduct	concept:agriculturalproduct:spices
concept:city:indianapolis	concept:proxyfor	concept:stateorprovince:indiana
concept:lake:new	concept:mutualproxyfor	concept:transportation:airports
concept:university:state_university	concept:synonymfor	concept:university:north_dakota_state
concept:book:new	concept:mutualproxyfor	concept:hallwayitem:market
concept:city:clearwater	concept:proxyfor	concept:city:florida
concept:city:greenwood	concept:locationlocatedwithinlocation	concept:stateorprovince:indiana
concept:lake:new	concept:mutualproxyfor	concept:geopoliticallocation:south_wales
concept:country:panama_city	concept:locationlocatedwithinlocation	concept:city:florida
concept:sportsteam:pirates	concept:teamplaysagainstteam	concept:sportsteam:philadelphia_phillies
concept:vegetable:pepper	concept:agriculturalproductcookedwithagriculturalproduct	concept:beverage:lime_juice
concept:vegetable:vinegar	concept:agriculturalproductcookedwithagriculturalproduct	concept:agriculturalproduct:black_pepper
concept:agriculturalproduct:cloves	concept:agriculturalproductcookedwithagriculturalproduct	concept:vegetable:pepper
concept:book:sandy	concept:mutualproxyfor	concept:county:utah
concept:sportsteam:ncaa_youth_kids	concept:agentcontrols	concept:coach:kansas_jayhawks
concept:sportsteam:bears_29_17	concept:organizationhiredperson	concept:coach:tedford
concept:mammal:primates	concept:specializationof	concept:mammal:animals
concept:sportsteam:los_angeles_lakers	concept:teamplaysagainstteam	concept:sportsteam:kings_college
concept:mammal:dogs	concept:animalistypeofanimal	concept:animal:pet
concept:politicaloffice:office	concept:synonymfor	concept:governmentorganization:dhhs
concept:city:fresno	concept:proxyfor	concept:stadiumoreventvenue:save_mart_center
concept:city:florida	concept:mutualproxyfor	concept:beach:gainesville
concept:coach:jersey	concept:proxyfor	concept:book:new
concept:politicsblog:image	concept:competeswith	concept:company:flickr001
concept:city:texas	concept:organizationterminatedperson	concept:coach:darrell_royal
concept:personmexico:ryan_whitney	concept:worksfor	concept:city:washington_d_c
concept:university:portland	concept:mutualproxyfor	concept:skiarea:maine
concept:book:new	concept:mutualproxyfor	concept:vehicle:publications
concept:county:utah	concept:mutualproxyfor	concept:city:layton
concept:hallwayitem:court	concept:mutualproxyfor	concept:book:new
concept:animal:pet	concept:animalpreyson	concept:mammal:animals
concept:coach:mike_tomlin	concept:personbelongstoorganization	concept:city:pittsburgh
concept:sportsequipment:board	concept:mutualproxyfor	concept:book:new
concept:sportsteam:chicago_cubs	concept:teamplaysagainstteam	concept:sportsteam:philadelphia_phillies
concept:vegetable:greens	concept:agriculturalproductcookedwithagriculturalproduct	concept:vegetable:pepper
concept:animal:birds002	concept:agentcompeteswithagent	concept:animal:eagle
concept:stateorprovince:states	concept:stateorprovinceisborderedbystateorprovince	concept:stateorprovince:indiana
concept:vegetable:pepper	concept:agriculturalproductcookedwithagriculturalproduct	concept:meat:chicken_breasts
concept:vehicle:states	concept:atlocation	concept:website:east
concept:mammal:pets	concept:animalistypeofanimal	concept:reptile:snakes
concept:newspaper:la_times	concept:competeswith	concept:newspaper:journal
concept:agriculturalproduct:black_pepper	concept:agriculturalproductcookedwithagriculturalproduct	concept:agriculturalproduct:mustard
concept:jobposition:partner	concept:mutualproxyfor	concept:sportsequipment:new
concept:city:santa_cruz_das_flores	concept:locationlocatedwithinlocation	concept:stateorprovince:california
concept:city:kokomo	concept:locationlocatedwithinlocation	concept:stateorprovince:indiana
concept:sportsteam:oklahoma_sooners_basketball	concept:teamplaysagainstteam	concept:sportsteam:longhorns
concept:food:peppers	concept:agriculturalproductcookedwithagriculturalproduct	concept:food:yellow_squash
concept:city:hawthorne	concept:citylocatedinstate	concept:stateorprovince:california
concept:city:cottage	concept:mutualproxyfor	concept:weatherphenomenon:two
concept:animal:creatures	concept:animalthatfeedoninsect	concept:insect:fleas
concept:profession:professions	concept:professionistypeofprofession	concept:profession:lawyers
concept:geopoliticalorganization:us_state	concept:proxyfor	concept:lake:new
concept:animal:birds002	concept:agentcompeteswithagent	concept:reptile:kestrel
concept:bank:google_checkout	concept:competeswith	concept:blog:google
concept:sportsteam:los_angeles_lakers	concept:teamplaysagainstteam	concept:sportsteam:esu_hornets
concept:city:carpinteria	concept:atlocation	concept:stateorprovince:california
concept:city:texas	concept:mutualproxyfor	concept:city:dallas
concept:city:san_marcos	concept:proxyfor	concept:stateorprovince:california
concept:musicsong:villa	concept:mutualproxyfor	concept:weatherphenomenon:two
concept:city:la_jolla	concept:proxyfor	concept:stateorprovince:california
concept:city:gardena	concept:atlocation	concept:stateorprovince:california
concept:sportsteam:brewers	concept:teamplaysagainstteam	concept:sportsteam:pirates
concept:country:yemen	concept:countrylocatedingeopoliticallocation	concept:stateorprovince:states
concept:vegetable:pepper	concept:agriculturalproductcookedwithagriculturalproduct	concept:meat:ribs
concept:sportsteam:red_sox_this_season	concept:teamplaysagainstteam	concept:sportsteam:washington_nationals
concept:sportsteam:sd_chargers	concept:teamplaysagainstteam	concept:sportsteam:new_orleans_saints
concept:book:new	concept:mutualproxyfor	concept:landscapefeatures:provinces
concept:room:house	concept:mutualproxyfor	concept:book:six
concept:book:new	concept:mutualproxyfor	concept:room:family
concept:retailstore:lake_havasu_city	concept:mutualproxyfor	concept:beverage:arizona
concept:book:new	concept:mutualproxyfor	concept:transportation:citizens
concept:city:york	concept:agentactsinlocation	concept:lake:new
concept:animal:moles	concept:animalistypeofanimal	concept:mammal:rodents
concept:nongovorganization:u_s_	concept:organizationhiredperson	concept:coach:greg_ryan
concept:mlconference:services_website	concept:subpartof	concept:city:texas
concept:city:danville	concept:proxyfor	concept:stateorprovince:virginia
concept:book:new	concept:mutualproxyfor	concept:hallwayitem:pick
concept:city:placentia	concept:citylocatedinstate	concept:stateorprovince:california
concept:mammal:monkeys	concept:animalpreyson	concept:mammal:pets
concept:animal:herbivores	concept:animalpreyson	concept:mammal:deer
concept:city:west_chester	concept:atlocation	concept:stateorprovince:pennsylvania
concept:university:ohio	concept:mutualproxyfor	concept:city:elyria
concept:city:evanston	concept:proxyfor	concept:stateorprovince:illinois
concept:city:glendale	concept:atlocation	concept:stateorprovince:california
concept:city:anaheim	concept:proxyfor	concept:stateorprovince:california
concept:profession:authors	concept:professionistypeofprofession	concept:profession:experts
concept:city:round_rock	concept:mutualproxyfor	concept:city:texas
concept:city:boston	concept:atlocation	concept:lake:new
concept:city:north_las_vegas	concept:citylocatedinstate	concept:stateorprovince:nevada
concept:lake:new	concept:mutualproxyfor	concept:month:september
concept:city:children	concept:agentcompeteswithagent	concept:reptile:pets
concept:sportsteam:ncaa_youth_kids	concept:agentcompeteswithagent	concept:sportsteam:wake_forest
concept:book:new	concept:mutualproxyfor	concept:country:orleans
concept:book:new	concept:atlocation	concept:island:territory
concept:stateorprovince:states	concept:statelocatedingeopoliticallocation	concept:stateorprovince:connecticut
concept:beverage:arizona	concept:mutualproxyfor	concept:sport:peoria
concept:personmexico:ryan_whitney	concept:worksfor	concept:politicalparty:democrats
concept:company:clinton	concept:agentcollaborateswithagent	concept:criminal:gore
concept:lake:new	concept:locationlocatedwithinlocation	concept:city:nyc_
concept:radiostation:nevada	concept:mutualproxyfor	concept:county:las_vegas
concept:vegetable:garlic	concept:agriculturalproductcookedwithagriculturalproduct	concept:agriculturalproduct:peppercorns
concept:county:las_vegas	concept:subpartof	concept:radiostation:nevada
concept:city:texas	concept:mutualproxyfor	concept:radiostation:san_antonio
concept:city:salinas	concept:locationlocatedwithinlocation	concept:stateorprovince:california
concept:stateorprovince:california	concept:mutualproxyfor	concept:city:costa_mesa
concept:bedroomitem:piece	concept:mutualproxyfor	concept:book:new
concept:stateorprovince:ocala	concept:mutualproxyfor	concept:city:florida
concept:animal:animals002	concept:animalpreyson	concept:reptile:mule_deer
concept:insect:bugs	concept:arthropodcalledarthropod	concept:insect:beetles
concept:food:italian_sausage	concept:agriculturalproductcookedwithagriculturalproduct	concept:food:peppers
concept:stateorprovince:california	concept:mutualproxyfor	concept:city:brea
concept:insect:bugs	concept:animalsuchasinvertebrate	concept:invertebrate:worms
concept:stateorprovince:ohio	concept:mutualproxyfor	concept:city:springfield
concept:mammal:bats	concept:animalistypeofanimal	concept:mammal:animals
concept:stateorprovince:california	concept:mutualproxyfor	concept:city:chico
concept:mammal:animals	concept:animalpreyson	concept:mammal:monkeys
concept:profession:professionals	concept:professionistypeofprofession	concept:profession:drivers
concept:city:emeryville	concept:subpartof	concept:stateorprovince:california
concept:city:service	concept:agentcontrols	concept:retailstore:aapl
concept:city:service	concept:subpartof	concept:retailstore:aapl
concept:building:hollywood	concept:subpartof	concept:city:florida
concept:newspaper:business_journal	concept:organizationheadquarteredincity	concept:city:washington_d_c
concept:personmexico:ryan_whitney	concept:worksfor	concept:governmentorganization:supreme_court
concept:stateorprovince:colorado	concept:mutualproxyfor	concept:city:greeley
concept:mammal:cows	concept:animalistypeofanimal	concept:animal:creatures
concept:city:home	concept:proxyfor	concept:website:google_s
concept:county:philadelphia	concept:subpartof	concept:stateorprovince:pennsylvania
concept:city:buena_park	concept:locationlocatedwithinlocation	concept:stateorprovince:california
concept:profession:professionals	concept:professionistypeofprofession	concept:profession:representatives
concept:sportsteam:dallas_cowboys	concept:teamplaysagainstteam	concept:sportsteam:broncos
concept:city:bremerton	concept:proxyfor	concept:city:washington_d_c
concept:food:peppers	concept:agriculturalproductcookedwithagriculturalproduct	concept:nut:sesame_seeds
concept:mammal:animals	concept:animalistypeofanimal	concept:agriculturalproduct:pigs
concept:agriculturalproduct:pasta	concept:agriculturalproductcookedwithagriculturalproduct	concept:vegetable:pepper
concept:stateorprovince:california	concept:mutualproxyfor	concept:city:san_rafael
concept:lake:new	concept:locationlocatedwithinlocation	concept:publication:people_
concept:blog:goal	concept:organizationterminatedperson	concept:ceo:john_o_shea
concept:city:washington_d_c	concept:subpartof	concept:country:united_states
concept:stateorprovince:illinois	concept:mutualproxyfor	concept:city:schaumburg
concept:weatherphenomenon:two	concept:mutualproxyfor	concept:director:committee
concept:city:warner_robins	concept:locationlocatedwithinlocation	concept:stateorprovince:georgia
concept:sportsteam:michigan_state	concept:subpartoforganization	concept:sportsteam:ncaa_youth_kids
concept:stateorprovince:georgia	concept:mutualproxyfor	concept:city:woodstock
concept:sportsteam:dodgers	concept:teamplaysagainstteam	concept:sportsteam:twins
concept:personmexico:ryan_whitney	concept:worksfor	concept:governmentorganization:commission
concept:sportsteam:red_sox	concept:teamplaysagainstteam	concept:sportsteam:white_sox
concept:book:new	concept:mutualproxyfor	concept:year:start
concept:mammal:animals	concept:animalpreyson	concept:mammal:hares
concept:agriculturalproduct:cauliflower	concept:agriculturalproductcookedwithagriculturalproduct	concept:food:peppers
concept:city:redwood_city	concept:locationlocatedwithinlocation	concept:stateorprovince:california
concept:eventoutcome:client	concept:proxyfor	concept:book:new
concept:stateorprovince:states	concept:statelocatedingeopoliticallocation	concept:country:vietnam
concept:profession:surgeons	concept:professionistypeofprofession	concept:profession:practitioners
concept:city:london_city	concept:proxyfor	concept:country:england
concept:profession:architects	concept:professionistypeofprofession	concept:profession:professionals
concept:city:santa_cruz_das_flores	concept:proxyfor	concept:stateorprovince:california
concept:profession:radiologists	concept:professionistypeofprofession	concept:profession:professionals
concept:city:woodland	concept:mutualproxyfor	concept:stateorprovince:california
concept:city:bellevue	concept:subpartof	concept:city:washington_d_c
concept:city:gastonia	concept:atlocation	concept:stateorprovince:north_carolina
concept:mammal:dogs	concept:animalistypeofanimal	concept:animal:birds002
concept:mammal:pets	concept:animalpreyson	concept:agriculturalproduct:livestock
concept:sportsteam:pirates	concept:teamplaysagainstteam	concept:sportsteam:yankees
concept:politicianus:jerry_brown	concept:personleadsgeopoliticalorganization	concept:city:oakland
concept:agriculturalproduct:mushroom	concept:agriculturalproductcookedwithagriculturalproduct	concept:vegetable:pepper
concept:city:poway	concept:mutualproxyfor	concept:stateorprovince:california
concept:mammal:domestic_animals	concept:animalistypeofanimal	concept:bird:chickens
concept:vegetable:carrots	concept:agriculturalproductcookedwithagriculturalproduct	concept:vegetable:pepper
concept:chemical:compounds	concept:chemicalistypeofchemical	concept:chemical:gases
concept:musicinstrument:mixture	concept:proxyfor	concept:book:new
concept:profession:professionals	concept:professionistypeofprofession	concept:profession:staff
concept:city:new_orleans	concept:mutualproxyfor	concept:geopoliticalorganization:nagin
concept:stateorprovince:colorado	concept:mutualproxyfor	concept:city:lakewood
concept:food:tomatoes	concept:agriculturalproductcookedwithagriculturalproduct	concept:vegetable:potatoes
concept:profession:professionals	concept:professionistypeofprofession	concept:profession:nurse_midwives
concept:city:petersburg	concept:subpartof	concept:stateorprovince:virginia
concept:city:marysville	concept:proxyfor	concept:stateorprovince:ohio
concept:weatherphenomenon:two	concept:mutualproxyfor	concept:book:new
concept:city:washington_d_c	concept:mutualproxyfor	concept:city:pullman
concept:shoppingmall:boynton_beach	concept:subpartof	concept:city:florida
concept:mammal:foxes	concept:animalpreyson	concept:animal:creatures
concept:politicalparty:republic	concept:synonymfor	concept:male:russia
concept:agriculturalproduct:cauliflower	concept:agriculturalproductcookedwithagriculturalproduct	concept:agriculturalproduct:spices
concept:restaurant:mecca	concept:proxyfor	concept:book:new
concept:winery:summers	concept:atlocation	concept:lake:new
concept:mammal:animals	concept:animalpreyson	concept:amphibian:frogs
concept:sportsteam:yankees	concept:teamplaysagainstteam	concept:sportsteam:red_sox_this_season
concept:year:n1997	concept:proxyfor	concept:lake:new
concept:lake:new	concept:mutualproxyfor	concept:year:n1986
concept:mammal:domesticated_animals	concept:animalpreyson	concept:mammal:dogs
concept:sportsteam:yankees	concept:teamplaysagainstteam	concept:sportsteam:atlanta_braves
concept:city:boston	concept:proxyfor	concept:programminglanguage:the_new
concept:book:new	concept:mutualproxyfor	concept:emotion:ability
concept:person:oscar_wyatt	concept:personbelongstoorganization	concept:city:texas
concept:sportsteam:washington_wizards	concept:teamplaysagainstteam	concept:sportsteam:cavs
concept:book:america	concept:synonymfor	concept:aquarium:u__s_
concept:stateorprovince:states	concept:statelocatedingeopoliticallocation	concept:country:croatia
concept:country:arabia_saudita	concept:locationlocatedwithinlocation	concept:country:countries
concept:sportsteam:red_sox	concept:teamplaysagainstteam	concept:sportsteam:twins
concept:visualizablescene:white_plains	concept:atlocation	concept:stateorprovince:new_york
concept:city:sarasota	concept:locationlocatedwithinlocation	concept:city:florida
concept:stateorprovince:california	concept:mutualproxyfor	concept:city:lynwood
concept:politician:michael_nutter	concept:worksfor	concept:county:philadelphia
concept:sportsteam:nuggets	concept:teamplaysagainstteam	concept:sportsteam:heat
concept:book:new	concept:mutualproxyfor	concept:book:north
concept:city:fredericksburg	concept:proxyfor	concept:stateorprovince:virginia
concept:mammal:pets	concept:animalistypeofanimal	concept:reptile:lizards
concept:profession:staff	concept:professionistypeofprofession	concept:profession:therapists
concept:profession:lawyers	concept:professionistypeofprofession	concept:profession:attorneys
concept:city:perris	concept:locationlocatedwithinlocation	concept:stateorprovince:california
concept:university:pennsylvania_state	concept:synonymfor	concept:university:state_university
concept:mammal:animals	concept:animalpreyson	concept:bird:eagles
concept:company:clinton	concept:agentcollaborateswithagent	concept:politician:congress
concept:sportsteam:spurs	concept:teamplaysagainstteam	concept:sportsteam:cavs
concept:county:brandon	concept:proxyfor	concept:city:florida
concept:sportsteam:ncaa_youth_kids	concept:agentcontrols	concept:coach:oklahoma_sooners
concept:retailstore:big_apple	concept:proxyfor	concept:lake:new
concept:mammal:whales	concept:animalpreyson	concept:mammal:animals
concept:country:honduras	concept:locationlocatedwithinlocation	concept:country:countries
concept:city:chula_vista	concept:locationlocatedwithinlocation	concept:stateorprovince:california
concept:sportsteam:ravens	concept:teamplaysagainstteam	concept:sportsteam:oakland_raiders
concept:sportsteam:pacers	concept:teamplaysagainstteam	concept:sportsteam:esu_hornets
concept:stateorprovince:states	concept:statelocatedingeopoliticallocation	concept:country:haiti
concept:mammal:pets	concept:animalpreyson	concept:mammal:rodents
concept:book:new	concept:subpartof	concept:website:market
concept:profession:professionals	concept:professionistypeofprofession	concept:profession:managers
concept:person:john003	concept:persongraduatedfromuniversity	concept:university:boston_college
concept:mammal:monkeys	concept:animalistypeofanimal	concept:mammal:pets
concept:city:dallas	concept:subpartof	concept:university:u_t_
concept:mammal:animals	concept:animalpreyson	concept:agriculturalproduct:livestock
concept:city:team	concept:organizationhiredperson	concept:personmexico:ryan_whitney
concept:book:new	concept:mutualproxyfor	concept:politicalparty:southern_states
concept:sportsteam:ncaa_youth_kids	concept:agentcompeteswithagent	concept:coach:cincinnati
concept:profession:staff	concept:professionistypeofprofession	concept:profession:specialists
concept:book:new	concept:mutualproxyfor	concept:buildingfeature:same_time
concept:city:hartford	concept:proxyfor	concept:stateorprovince:connecticut
concept:university:ohio	concept:mutualproxyfor	concept:county:columbus
concept:city:miami_beach	concept:atlocation	concept:city:florida
concept:agriculturalproduct:season	concept:agriculturalproductcookedwithagriculturalproduct	concept:agriculturalproduct:cayenne_pepper
concept:weatherphenomenon:two	concept:mutualproxyfor	concept:hobby:bungalow
concept:profession:assistants	concept:professionistypeofprofession	concept:profession:staff
concept:city:grapevine	concept:citylocatedinstate	concept:stateorprovince:texas
concept:amphibian:frogs	concept:animalpreyson	concept:mammal:pets
concept:city:duluth	concept:locationlocatedwithinlocation	concept:stateorprovince:minnesota
concept:geopoliticalorganization:northern	concept:atlocation	concept:continent:africa
concept:amphibian:salamanders	concept:animalistypeofanimal	concept:mammal:animals
concept:city:lodi	concept:subpartof	concept:stateorprovince:california
concept:city:flagstaff	concept:subpartof	concept:stateorprovince:arizona
concept:sportsteam:bucs	concept:teamplaysagainstteam	concept:sportsteam:new_orleans_saints
concept:athlete:mike_singletary	concept:athleteplaysforteam	concept:sportsteam:bears_29_17
concept:city:istanbul	concept:proxyfor	concept:country:turkey
concept:city:florida	concept:mutualproxyfor	concept:visualizablething:naples
concept:academicfield:lubbock	concept:atlocation	concept:city:texas
concept:city:monrovia	concept:atlocation	concept:stateorprovince:california
concept:stateorprovince:california	concept:mutualproxyfor	concept:city:chula_vista
concept:profession:professionals	concept:professionistypeofprofession	concept:profession:pilots
concept:sportsteam:chicago_cubs	concept:teamplaysagainstteam	concept:sportsteam:pittsburgh_pirates
concept:personmexico:ryan_whitney	concept:personleadsorganization	concept:governmentorganization:united_states_congress
concept:coach:mark_richt	concept:personbelongstoorganization	concept:stateorprovince:georgia
concept:city:hope	concept:agentactsinlocation	concept:lake:new
concept:mammal:monkeys	concept:animalistypeofanimal	concept:mammal:animals
concept:city:washington_d_c	concept:mutualproxyfor	concept:city:yakima
concept:biotechcompany:section	concept:agentcompeteswithagent	concept:architect:criticism
concept:mammal:dogs	concept:animalistypeofanimal	concept:mammal:animals
concept:sportsteam:yankees	concept:organizationhiredperson	concept:person:rodriguez
concept:professionalorganization:cia	concept:organizationhiredperson	concept:personmexico:ryan_whitney
concept:country:cameroon	concept:countrylocatedingeopoliticallocation	concept:stateorprovince:states
concept:profession:psychologists	concept:professionistypeofprofession	concept:profession:practitioners
concept:city:dallas	concept:subpartof	concept:stateorprovince:ut
concept:vegetable:pepper	concept:agriculturalproductcookedwithagriculturalproduct	concept:food:green_olives
concept:reptile:turtles	concept:animalistypeofanimal	concept:mammal:pets
concept:bird:owls	concept:animalpreyson	concept:animal:birds002
concept:city:santa_rosa	concept:atlocation	concept:stateorprovince:california
concept:city:redmond	concept:proxyfor	concept:city:washington_d_c
concept:book:new	concept:proxyfor	concept:visualizableattribute:minutes
concept:book:new	concept:mutualproxyfor	concept:book:tour
concept:city:hampshire	concept:locationlocatedwithinlocation	concept:country:us
concept:sportsequipment:feet	concept:mutualproxyfor	concept:book:new
concept:mammal:bear	concept:mammalsuchasmammal	concept:mammal:dogs
concept:city:westminster	concept:atlocation	concept:stateorprovince:california
concept:person:rodriguez	concept:personbornincity	concept:city:york
concept:radiostation:nevada	concept:mutualproxyfor	concept:bank:henderson
concept:city:service	concept:agentcontrols	concept:company:pixar
concept:university:state_university	concept:mutualproxyfor	concept:geometricshape:colleges
concept:profession:practitioners	concept:professionistypeofprofession	concept:profession:technicians
concept:agriculturalproduct:pigs	concept:animalpreyson	concept:mammal:animals
concept:lake:new	concept:mutualproxyfor	concept:visualizablescene:harbor
concept:person:mugabe	concept:personleadsgeopoliticalorganization	concept:stateorprovince:eu
concept:university:national_science_foundation	concept:synonymfor	concept:politicaloffice:office
concept:person:duke	concept:agentcollaborateswithagent	concept:sportsteam:ncaa_youth_kids
concept:book:new	concept:mutualproxyfor	concept:emotion:land
concept:city:wellington	concept:locationlocatedwithinlocation	concept:country:new_zealand
concept:city:pleasanton	concept:proxyfor	concept:stateorprovince:california
concept:city:washington_d_c	concept:mutualproxyfor	concept:city:puyallup
concept:mammal:dogs	concept:animalistypeofanimal	concept:mammal:household_pets
concept:blog:google	concept:competeswith	concept:website:facebook
concept:reptile:snakes	concept:animalpreyson	concept:animal:creatures
concept:university:illinois_state	concept:synonymfor	concept:university:state_university
concept:city:woodland	concept:atlocation	concept:stateorprovince:california
concept:city:ventura	concept:subpartof	concept:stateorprovince:california
concept:book:new	concept:proxyfor	concept:room:dates
concept:agriculturalproduct:pigs	concept:animalistypeofanimal	concept:mammal:domestic_animals
concept:mammal:cows	concept:agriculturalproductincludingagriculturalproduct	concept:meat:beef
concept:city:tehran	concept:citycapitalofcountry	concept:country:iran
concept:food:peppers	concept:agriculturalproductcookedwithagriculturalproduct	concept:meat:bacon
concept:city:meriden	concept:atlocation	concept:stateorprovince:connecticut
concept:county:tracy	concept:subpartof	concept:stateorprovince:california
concept:island:new_york_city_metropolitan_area	concept:proxyfor	concept:book:new
concept:profession:scientists	concept:professionistypeofprofession	concept:profession:providers
concept:stateorprovince:indiana	concept:mutualproxyfor	concept:city:lafayette
concept:mammal:coyotes	concept:animalistypeofanimal	concept:mammal:mammals
concept:profession:practitioners	concept:professionistypeofprofession	concept:profession:physical_therapists
concept:sportsteam:yankees	concept:teamplaysagainstteam	concept:sportsteam:arizona_diamond_backs
concept:city:florida	concept:mutualproxyfor	concept:county:brandon
concept:university:state_university	concept:synonymfor	concept:geopoliticallocation:central_michigan
concept:city:cape_coral	concept:locationlocatedwithinlocation	concept:city:florida
concept:city:arlington	concept:proxyfor	concept:stateorprovince:virginia
concept:city:washington_d_c	concept:subpartof	concept:stateorprovince:pennsylvania
concept:animal:creatures	concept:animalsuchasinsect	concept:insect:bugs
concept:sportsteam:los_angeles_dodgers	concept:teamplaysagainstteam	concept:sportsteam:white_sox
concept:mammal:horses	concept:animalistypeofanimal	concept:mammal:pets
concept:food:garlic_cloves	concept:agriculturalproductcookedwithagriculturalproduct	concept:food:peppers
concept:sportsteam:lsu	concept:teamplaysagainstteam	concept:sportsteam:florida_gators
concept:stateorprovince:california	concept:mutualproxyfor	concept:city:el_monte
concept:city:simi_valley	concept:locationlocatedwithinlocation	concept:stateorprovince:california
concept:country:portugal	concept:countrylocatedingeopoliticallocation	concept:stateorprovince:states
concept:mammal:cats	concept:animalistypeofanimal	concept:animal:pet
concept:city:washington_d_c	concept:proxyfor	concept:musicalbum:us
concept:city:woodland_hills	concept:subpartof	concept:stateorprovince:california
concept:animal:humans	concept:animalpreyson	concept:mammal:mammals
concept:sportsteam:ncaa_youth_kids	concept:agentcompeteswithagent	concept:comedian:oklahoma
concept:mammal:deer	concept:mammalsuchasmammal	concept:mammal:rabbits
concept:city:roswell	concept:locationlocatedwithinlocation	concept:stateorprovince:georgia
concept:agriculturalproduct:spices	concept:agriculturalproductcookedwithagriculturalproduct	concept:agriculturalproduct:lamb
concept:profession:acupuncturists	concept:professionistypeofprofession	concept:profession:practitioners
concept:sportsteam:houston_astros	concept:teamplaysagainstteam	concept:sportsteam:yankees
concept:sportsteam:new_jersey_nets	concept:teamplaysagainstteam	concept:sportsteam:washington_wizards
concept:sportsteam:red_sox_this_season	concept:teamplaysagainstteam	concept:sportsteam:pirates
concept:stateorprovince:california	concept:mutualproxyfor	concept:city:arcata
concept:newspaper:journal	concept:competeswith	concept:website:washington_post
concept:university:state_university	concept:synonymfor	concept:university:ohio
concept:animal:herbivores	concept:animalpreyson	concept:mammal:rabbits
concept:agriculturalproduct:salt	concept:agriculturalproductcookedwithagriculturalproduct	concept:vegetable:parsley
concept:city:richland	concept:atlocation	concept:city:washington_d_c
concept:stateorprovince:california	concept:mutualproxyfor	concept:city:carmel_by_the_sea
concept:city:la_jolla	concept:locationlocatedwithinlocation	concept:stateorprovince:california
concept:company:new_york	concept:mutualproxyfor	concept:county:manhattan
concept:company:apple002	concept:agentcollaborateswithagent	concept:politicianus:john_sculley
concept:university:state_university	concept:organizationalsoknownas	concept:university:illinois_state
concept:shoppingmall:pompano_beach	concept:subpartof	concept:city:florida
concept:city:portsmouth	concept:proxyfor	concept:stateorprovince:virginia
concept:country:cyprus	concept:countrylocatedingeopoliticallocation	concept:stateorprovince:states
concept:mammal:cows	concept:animalistypeofanimal	concept:animal:herbivores
concept:city:marysville	concept:subpartof	concept:city:washington_d_c
concept:book:new	concept:proxyfor	concept:sportsgame:more_days
concept:reptile:geckos	concept:animalpreyson	concept:mammal:pets
concept:mammal:animals	concept:animalpreyson	concept:reptile:alligators
concept:sportsteam:los_angeles_lakers	concept:teamplaysagainstteam	concept:sportsteam:new_jersey_nets
concept:stadiumoreventvenue:paradise	concept:atlocation	concept:city:boston
concept:city:london_city	concept:agentcompeteswithagent	concept:newspaper:journal
concept:coach:philip_fulmer	concept:worksfor	concept:stateorprovince:volunteer
concept:city:san_ramon	concept:atlocation	concept:stateorprovince:california
concept:stateorprovince:california	concept:mutualproxyfor	concept:city:simi_valley
concept:book:new	concept:mutualproxyfor	concept:parlourgame:short_drive
concept:county:columbus	concept:proxyfor	concept:stadiumoreventvenue:lifestyles_communities_pavilion
concept:city:buenos_aires	concept:citylocatedincountry	concept:country:argentina
concept:agriculturalproduct:chili_powder	concept:agriculturalproductcookedwithagriculturalproduct	concept:vegetable:pepper
concept:book:new	concept:mutualproxyfor	concept:musicinstrument:games
concept:sportsteam:los_angeles_lakers	concept:teamplaysagainstteam	concept:sportsteam:spurs
concept:city:dallas	concept:locationlocatedwithinlocation	concept:stateorprovince:ut
concept:stateorprovince:california	concept:mutualproxyfor	concept:zoo:atascadero
concept:hallwayitem:subject	concept:mutualproxyfor	concept:book:new
concept:university:brownsville	concept:atlocation	concept:city:texas
concept:city:plano	concept:proxyfor	concept:stateorprovince:texas
concept:city:washington_d_c	concept:agentcompeteswithagent	concept:politicsblog:tribune
concept:book:new	concept:atlocation	concept:geopoliticallocation:u_s__state
concept:city:vero_beach	concept:proxyfor	concept:city:florida
concept:vegetable:pepper	concept:agriculturalproductcookedwithagriculturalproduct	concept:food:potato_salad
concept:city:florida	concept:mutualproxyfor	concept:city:vero_beach
concept:winery:summers	concept:proxyfor	concept:book:new
concept:actor:scott_mcnealy	concept:agentcollaborateswithagent	concept:male:sun
concept:reptile:turtles	concept:animalpreyson	concept:mammal:animals
concept:city:cypress	concept:subpartof	concept:stateorprovince:california
concept:stateorprovince:georgia	concept:subpartoforganization	concept:sportsteam:ncaa_youth_kids
concept:city:dallas	concept:citylocatedingeopoliticallocation	concept:stateorprovince:texas
concept:reptile:references	concept:agentcompeteswithagent	concept:city:article
concept:vegetable:pepper	concept:agriculturalproductcookedwithagriculturalproduct	concept:agriculturalproduct:green_onions
concept:politician:greg_nickels	concept:personleadsgeopoliticalorganization	concept:county:seattle
concept:city:lake_forest	concept:citylocatedinstate	concept:stateorprovince:california
concept:book:new	concept:mutualproxyfor	concept:island:metropolitan_region
concept:city:allentown	concept:proxyfor	concept:stateorprovince:pennsylvania
concept:university:state_university	concept:organizationalsoknownas	concept:county:louisiana_state
concept:city:fallbrook	concept:locationlocatedwithinlocation	concept:stateorprovince:california
concept:city:casa_grande	concept:atlocation	concept:stateorprovince:arizona
concept:country:former_soviet_union	concept:countryalsoknownas	concept:country:russian_federation
concept:book:new	concept:mutualproxyfor	concept:restaurant:melting_pot
concept:city:boca_raton	concept:citylocatedingeopoliticallocation	concept:city:florida
concept:bird:ducks	concept:animalpreyson	concept:mammal:animals
concept:agriculturalproduct:chili	concept:agriculturalproductcookedwithagriculturalproduct	concept:food:peppers
concept:city:team	concept:agentcollaborateswithagent	concept:politician:jobs
concept:city:newport_news_hampton_wmsburg	concept:proxyfor	concept:stateorprovince:virginia
concept:mammal:animals	concept:animalpreyson	concept:animal:bunnies
concept:lake:new	concept:locationlocatedwithinlocation	concept:landscapefeatures:parks
concept:agriculturalproduct:livestock	concept:animalistypeofanimal	concept:mammal:dogs
concept:sportsteam:los_angeles_lakers	concept:teamplaysagainstteam	concept:sportsteam:washington_wizards
concept:city:texas	concept:mutualproxyfor	concept:city:san_marcos
concept:city:texas	concept:agentcontrols	concept:mlconference:services_website
concept:sportsteam:knicks	concept:teamplaysagainstteam	concept:sportsteam:new_jersey_nets
concept:stateorprovince:california	concept:stateorprovinceisborderedbystateorprovince	concept:stateorprovince:southern_oregon
concept:lake:new	concept:mutualproxyfor	concept:country:england
concept:reptile:iguanas	concept:animalistypeofanimal	concept:mammal:pets
concept:city:frisco	concept:proxyfor	concept:stateorprovince:texas
concept:city:normal	concept:proxyfor	concept:stateorprovince:illinois
concept:sportsequipment:board	concept:mutualproxyfor	concept:book:forum
concept:stateorprovince:california	concept:mutualproxyfor	concept:city:ontario
concept:geopoliticallocation:santa_maria	concept:locationlocatedwithinlocation	concept:stateorprovince:california
concept:animal:herbivores	concept:animalistypeofanimal	concept:mammal:horses
concept:county:tyler	concept:locationlocatedwithinlocation	concept:city:texas
concept:country:uganda	concept:countrylocatedingeopoliticallocation	concept:stateorprovince:states
concept:book:new	concept:mutualproxyfor	concept:criminal:england_area
concept:stateorprovince:california	concept:mutualproxyfor	concept:city:chino
concept:stateorprovince:nevada	concept:mutualproxyfor	concept:city:sparks
concept:city:brea	concept:mutualproxyfor	concept:stateorprovince:california
concept:hallwayitem:point	concept:mutualproxyfor	concept:book:new
concept:university:state_university	concept:synonymfor	concept:county:louisiana_state
concept:profession:technicians	concept:professionistypeofprofession	concept:profession:experts
concept:agriculturalproduct:pigs	concept:animalpreyson	concept:mammal:rodents
concept:mammal:dogs	concept:animalistypeofanimal	concept:animal:humans
concept:city:florida	concept:mutualproxyfor	concept:city:deerfield_beach
concept:coach:lovie_smith	concept:worksfor	concept:county:chicago
concept:visualizablescene:hollywood	concept:proxyfor	concept:stateorprovince:california
concept:company:focus	concept:mutualproxyfor	concept:coach:new
concept:stateorprovince:states	concept:statelocatedingeopoliticallocation	concept:country:czechoslovakia
concept:company:new_york	concept:mutualproxyfor	concept:island:new_york_city_metropolitan_area
concept:book:new	concept:atlocation	concept:street:lots
concept:profession:litigators	concept:professionistypeofprofession	concept:profession:attorneys
concept:politician:jobs	concept:persongraduatedschool	concept:university:state_university
concept:sportsteam:orlando_magic	concept:teamplaysagainstteam	concept:sportsteam:los_angeles_lakers
concept:company:aol_	concept:subpartoforganization	concept:website:netscape
concept:stateorprovince:states	concept:statelocatedingeopoliticallocation	concept:country:chile
concept:vegetable:pepper	concept:agriculturalproductcookedwithagriculturalproduct	concept:agriculturalproduct:black_pepper
concept:sportsteam:white_sox	concept:teamplaysagainstteam	concept:sportsteam:texas_rangers
concept:agriculturalproduct:salt	concept:agriculturalproductcookedwithagriculturalproduct	concept:vegetable:garlic
concept:city:roswell	concept:proxyfor	concept:stateorprovince:georgia
concept:sportsteam:nuggets	concept:teamplaysagainstteam	concept:sportsteam:indiana_pacers
concept:coach:cincinnati	concept:mutualproxyfor	concept:university:ohio
concept:book:new	concept:mutualproxyfor	concept:book:america
concept:vegetable:onion	concept:agriculturalproductcookedwithagriculturalproduct	concept:vegetable:garlic
concept:city:beaumont	concept:proxyfor	concept:stateorprovince:texas
concept:blog:google	concept:competeswith	concept:website:netscape
concept:sport:peoria	concept:proxyfor	concept:beverage:arizona
concept:sportsteam:florida_international	concept:teamplaysagainstteam	concept:sportsteam:tampa
concept:lake:new	concept:mutualproxyfor	concept:visualizablething:residence
concept:city:cerritos	concept:mutualproxyfor	concept:stateorprovince:california
concept:city:kolkata	concept:citylocatedinstate	concept:stateorprovince:west_bengal
concept:profession:attorneys	concept:professionistypeofprofession	concept:profession:professionals
concept:stateorprovince:illinois	concept:mutualproxyfor	concept:city:decatur
concept:agriculturalproduct:black_pepper	concept:agriculturalproductcookedwithagriculturalproduct	concept:agriculturalproduct:lemon
concept:book:new	concept:mutualproxyfor	concept:comedian:day
concept:city:baytown	concept:mutualproxyfor	concept:city:texas
concept:book:new	concept:mutualproxyfor	concept:book:refuge
concept:mammal:hares	concept:animalsuchasinvertebrate	concept:animal:small_mammals
concept:stateorprovince:illinois	concept:organizationterminatedperson	concept:coach:bruce_weber
concept:agriculturalproduct:sides	concept:agriculturalproductcookedwithagriculturalproduct	concept:vegetable:pepper
concept:book:new	concept:mutualproxyfor	concept:emotion:doubt
concept:musicinstrument:resource	concept:mutualproxyfor	concept:book:new
concept:stateorprovince:states	concept:statelocatedingeopoliticallocation	concept:country:palestine
concept:newspaper:sun_microsystems	concept:competeswith	concept:blog:google
concept:vegetable:celery	concept:agriculturalproductcookedwithagriculturalproduct	concept:food:peppers
concept:city:springfield	concept:subpartof	concept:stateorprovince:missouri
concept:tradeunion:search	concept:agentcompeteswithagent	concept:musician:material
concept:city:williamsport	concept:proxyfor	concept:stateorprovince:pennsylvania
concept:stateorprovince:arizona	concept:stateorprovinceisborderedbystateorprovince	concept:stateorprovince:utah
concept:city:vallejo	concept:proxyfor	concept:stateorprovince:california
concept:ceo:bernard_l__madoff	concept:personleadsorganization	concept:nongovorganization:u_s_
concept:animal:humans	concept:animalistypeofanimal	concept:mammal:cats
concept:country:england	concept:proxyfor	concept:lake:new
concept:profession:practitioners	concept:professionistypeofprofession	concept:profession:counselors
concept:city:vancouver	concept:proxyfor	concept:lake:new
concept:country:russian_federation	concept:countrylocatedingeopoliticallocation	concept:stateorprovince:states
concept:governmentorganization:u_s__dept	concept:synonymfor	concept:politicaloffice:office
concept:book:new	concept:mutualproxyfor	concept:food:new_england
concept:lake:new	concept:locationlocatedwithinlocation	concept:visualizablething:residence
concept:city:bellevue	concept:subpartof	concept:stateorprovince:nebraska
concept:sportsteam:ottawa_senators	concept:teamplaysagainstteam	concept:sportsteam:new_york_islanders
concept:profession:professionals	concept:professionistypeofprofession	concept:jobposition:physician
concept:stateorprovince:virginia	concept:mutualproxyfor	concept:county:williamsburg
concept:monument:nebraska_cornhuskers	concept:subpartof	concept:sportsteam:ncaa_youth_kids
concept:agriculturalproduct:marjoram	concept:agriculturalproductcookedwithagriculturalproduct	concept:vegetable:pepper
concept:date:n1996	concept:proxyfor	concept:lake:new
concept:mammal:deer	concept:animalistypeofanimal	concept:animal:creatures
concept:mammal:dogs	concept:animaleatfood	concept:food:eggs
concept:mammal:animals	concept:animalpreyson	concept:mammal:rabbits
concept:stateorprovince:california	concept:mutualproxyfor	concept:city:martinez
concept:vegetable:pepper	concept:agriculturalproductcookedwithagriculturalproduct	concept:agriculturalproduct:gravy
concept:sportsteam:ncaa_youth_kids	concept:subpartoforganization	concept:sportsteam:ncaa_mens_midwest_regionals
concept:musicalbum:decades	concept:mutualproxyfor	concept:book:new
concept:book:network	concept:mutualproxyfor	concept:book:new
concept:university:north_dakota_state	concept:synonymfor	concept:university:state_university
concept:highway:the_new	concept:mutualproxyfor	concept:company:new_york
concept:radiostation:new_jersey	concept:mutualproxyfor	concept:beach:beach_haven
concept:book:new	concept:mutualproxyfor	concept:visualizablething:semesters
concept:agriculturalproduct:livestock	concept:animalistypeofanimal	concept:mammal:horses
concept:stateorprovince:oregon	concept:organizationhiredperson	concept:male:vin_lananna
concept:city:florida	concept:mutualproxyfor	concept:beach:jacksonville
concept:insect:mites	concept:animalsuchasinvertebrate	concept:insect:bugs
concept:county:orange_county	concept:proxyfor	concept:stateorprovince:california
concept:politicalparty:republic	concept:synonymfor	concept:book:america
concept:profession:health_care_professionals	concept:professionistypeofprofession	concept:profession:professionals
concept:mammal:guinea_pigs	concept:animalistypeofanimal	concept:mammal:animals
concept:sportsteam:texas_rangers	concept:teamplaysagainstteam	concept:sportsteam:twins
concept:city:killeen	concept:mutualproxyfor	concept:city:texas
concept:insect:crabs	concept:animalistypeofanimal	concept:animal:creatures
concept:stadiumoreventvenue:clowes_memorial_hall	concept:locationlocatedwithinlocation	concept:city:indianapolis
concept:agriculturalproduct:herbs	concept:agriculturalproductcookedwithagriculturalproduct	concept:agriculturalproduct:black_pepper
concept:eventoutcome:disaster	concept:mutualproxyfor	concept:book:new
concept:sportsteam:ncaa_youth_kids	concept:agentcompeteswithagent	concept:city:xavier
concept:city:amherst	concept:proxyfor	concept:beach:massachusetts
concept:vegetable:pepper	concept:agriculturalproductcookedwithagriculturalproduct	concept:fruit:lemons
concept:animal:creatures	concept:animalpreyson	concept:animal:moles
concept:mammal:monkeys	concept:animalpreyson	concept:mammal:exotic_animals
concept:animal:organisms	concept:animalthatfeedoninsect	concept:insect:mites
concept:mammal:cats	concept:animalpreyson	concept:mammal:domestic_animals
concept:city:florida	concept:mutualproxyfor	concept:city:daytona_beach
concept:city:broomfield	concept:atlocation	concept:stateorprovince:colorado
concept:year:n1997	concept:subpartof	concept:stateorprovince:colorado
concept:mammal:rodents	concept:animalistypeofanimal	concept:mammal:pets
concept:emotion:senate	concept:mutualproxyfor	concept:vehicle:three
concept:stateorprovince:california	concept:mutualproxyfor	concept:county:orange_county
concept:city:denver	concept:citylocatedinstate	concept:stateorprovince:colorado
concept:city:fremont	concept:atlocation	concept:stateorprovince:california
concept:sportsteam:ncaa_youth_kids	concept:agentcompeteswithagent	concept:coach:clemson
concept:city:palm_desert	concept:atlocation	concept:stateorprovince:california
concept:city:sonora	concept:mutualproxyfor	concept:stateorprovince:california
concept:sportsteam:phils	concept:teamplaysagainstteam	concept:sportsteam:dodgers
concept:city:puyallup	concept:proxyfor	concept:city:washington_d_c
concept:county:athens	concept:locationlocatedwithinlocation	concept:stateorprovince:georgia
concept:sportsteam:sd_chargers	concept:teamplaysagainstteam	concept:sportsteam:dallas_cowboys
concept:city:greeley	concept:citylocatedingeopoliticallocation	concept:stateorprovince:colorado
concept:lake:new	concept:mutualproxyfor	concept:stateorprovince:new_york_state
concept:city:meriden	concept:proxyfor	concept:stateorprovince:connecticut
concept:bathroomitem:firm	concept:mutualproxyfor	concept:book:new
concept:city:kissimmee	concept:locationlocatedwithinlocation	concept:city:florida
concept:stateorprovince:california	concept:mutualproxyfor	concept:city:fullerton
concept:governmentorganization:management	concept:organizationacronymhasname	concept:governmentorganization:doe_office
concept:coach:jersey	concept:atlocation	concept:stateorprovince:new_york
concept:sportsteam:red_sox	concept:teamplaysagainstteam	concept:sportsteam:texas_rangers
concept:country:prussia	concept:countrylocatedingeopoliticallocation	concept:stateorprovince:states
concept:animal:pet	concept:animalpreyson	concept:mammal:pets
concept:city:portsmouth	concept:subpartof	concept:stateorprovince:virginia
concept:animal:humans	concept:animalistypeofanimal	concept:mammal:dogs
concept:mammal:animals	concept:animalpreyson	concept:reptile:turtles
concept:blog:google	concept:competeswith	concept:company:live
concept:sportsteam:bears_29_17	concept:teamplaysagainstteam	concept:sportsteam:rams
concept:lake:new	concept:locationlocatedwithinlocation	concept:city:american_city
concept:book:new	concept:mutualproxyfor	concept:book:gateway
concept:coach:brad_childress	concept:athleteplaysinleague	concept:sportsleague:nfl
concept:bird:chickens	concept:animalistypeofanimal	concept:agriculturalproduct:livestock
concept:city:washington_d_c	concept:locationlocatedwithinlocation	concept:country:united_states
concept:county:manchester	concept:atlocation	concept:stateorprovince:connecticut
concept:animal:creatures	concept:animalistypeofanimal	concept:mammal:cats
concept:city:renton	concept:locationlocatedwithinlocation	concept:city:washington_d_c
concept:year:n1981	concept:proxyfor	concept:stateorprovince:california
concept:sportsteam:bengals	concept:teamplaysagainstteam	concept:sportsteam:yankees
concept:mammal:internet_dog	concept:animalistypeofanimal	concept:mammal:dogs
concept:musicsong:villa	concept:mutualproxyfor	concept:coach:n3
concept:mammal:water_buffalo	concept:animalistypeofanimal	concept:mammal:animals
concept:male:sun	concept:agentactsinlocation	concept:city:washington_d_c
concept:sportsteam:yanks	concept:teamplaysagainstteam	concept:sportsteam:red_sox_this_season
concept:musicalbum:us	concept:mutualproxyfor	concept:book:new
concept:actor:scott_mcnealy	concept:agentcontrols	concept:male:sun
concept:amphibian:frogs	concept:animalistypeofanimal	concept:animal:creatures
concept:country:arabia_saudita	concept:locationlocatedwithinlocation	concept:stateorprovince:states
concept:lake:new	concept:locationlocatedwithinlocation	concept:stateorprovince:new_york_state
concept:sportsteam:los_angeles_lakers	concept:teamplaysagainstteam	concept:sportsteam:rockets
concept:lake:new	concept:mutualproxyfor	concept:country:west_indies
concept:agriculturalproduct:celery_seed	concept:agriculturalproductcookedwithagriculturalproduct	concept:vegetable:pepper
concept:city:san_marcos	concept:citylocatedinstate	concept:stateorprovince:california
concept:animal:creatures	concept:animalpreyson	concept:mammal:bears
concept:book:new	concept:mutualproxyfor	concept:winery:york_areas
concept:city:roanoke	concept:proxyfor	concept:stateorprovince:virginia
concept:agriculturalproduct:black_pepper	concept:agriculturalproductcookedwithagriculturalproduct	concept:vegetable:onion
concept:profession:services	concept:professionistypeofprofession	concept:profession:specialists
concept:sportsequipment:board	concept:mutualproxyfor	concept:county:chamber
concept:stateorprovince:line	concept:organizationhiredperson	concept:personmexico:ryan_whitney
concept:vegetable:parsley	concept:agriculturalproductcookedwithagriculturalproduct	concept:vegetable:pepper
concept:city:palo_alto	concept:subpartof	concept:stateorprovince:california
concept:city:vista	concept:proxyfor	concept:stateorprovince:california
concept:animal:creatures	concept:animalthatfeedoninsect	concept:insect:beetles
concept:book:new	concept:proxyfor	concept:emotion:night
concept:island:staff	concept:mutualproxyfor	concept:sportsequipment:board
concept:city:muncie	concept:atlocation	concept:stateorprovince:indiana
concept:mammal:cats	concept:animalpreyson	concept:animal:birds002
concept:researchproject:housing	concept:mutualproxyfor	concept:book:new
concept:book:new	concept:mutualproxyfor	concept:visualizableobject:world
concept:city:washington_d_c	concept:locationlocatedwithinlocation	concept:country:us
concept:mammal:cats	concept:animalistypeofanimal	concept:mammal:animals
concept:musicinstrument:news	concept:mutualproxyfor	concept:book:new
concept:animal:hawks	concept:animalpreyson	concept:animal:birds002
concept:stateorprovince:california	concept:mutualproxyfor	concept:city:emeryville
concept:profession:primary_care_physicians	concept:professionistypeofprofession	concept:profession:providers
concept:beach:massachusetts	concept:mutualproxyfor	concept:city:pittsfield
concept:lake:new	concept:mutualproxyfor	concept:stateorprovince:pennsylvania
concept:profession:physical_therapists	concept:professionistypeofprofession	concept:profession:staff
concept:biotechcompany:white	concept:agentbelongstoorganization	concept:governmentorganization:house
concept:country:lebanon	concept:countrylocatedingeopoliticallocation	concept:stateorprovince:states
concept:stateorprovince:california	concept:mutualproxyfor	concept:city:ventura
concept:county:atlanta	concept:subpartof	concept:stateorprovince:georgia
concept:jobposition:nurse	concept:professionistypeofprofession	concept:profession:assistants
concept:company:wikipedia001	concept:competeswith	concept:website:facebook
concept:coach:rick_barnes	concept:worksfor	concept:city:texas
concept:sportsteam:arizona_diamond_backs	concept:teamplaysagainstteam	concept:sportsteam:red_sox
concept:sportsteam:cavs	concept:organizationhiredperson	concept:writer:brown
concept:visualizablething:altamonte_springs	concept:proxyfor	concept:city:florida
concept:personmexico:ryan_whitney	concept:worksfor	concept:governmentorganization:us_congress
concept:mammal:dogs	concept:animalpreyson	concept:animal:babies
concept:website:facebook	concept:competeswith	concept:company:msn
concept:agriculturalproduct:pigs	concept:animalistypeofanimal	concept:mammal:rodents
concept:mammal:cats	concept:animalistypeofanimal	concept:mammal:household_pets
concept:stateorprovince:california	concept:mutualproxyfor	concept:city:san_pablo
concept:sportsteam:knicks	concept:teamplaysagainstteam	concept:sportsteam:rockets
concept:city:san_bernardino	concept:proxyfor	concept:stateorprovince:california
concept:country:russia	concept:countryalsoknownas	concept:country:soviet_union
concept:animal:creatures	concept:animalistypeofanimal	concept:mammal:dogs
concept:biotechcompany:gateway_2000	concept:subpartof	concept:plant:acer
concept:profession:nurses	concept:professionistypeofprofession	concept:profession:members
concept:vegetable:pepper	concept:agriculturalproductcookedwithagriculturalproduct	concept:vegetable:corn
concept:city:quincy	concept:proxyfor	concept:stateorprovince:illinois
concept:stateorprovince:indiana	concept:mutualproxyfor	concept:city:richmond
concept:mammal:dogs	concept:animalistypeofanimal	concept:animal:creatures
concept:lake:new	concept:mutualproxyfor	concept:retailstore:big_apple
concept:city:beverly_hills	concept:proxyfor	concept:stateorprovince:california
concept:county:olympia	concept:proxyfor	concept:city:washington_d_c
concept:personmexico:ryan_whitney	concept:personleadsorganization	concept:governmentorganization:commission
concept:reptile:lizards	concept:animalpreyson	concept:mammal:pets
concept:city:santa_clarita	concept:proxyfor	concept:stateorprovince:california
concept:country:switzerland	concept:countrylocatedingeopoliticallocation	concept:stateorprovince:states
concept:city:santa_barbara_de_nexe	concept:locationlocatedwithinlocation	concept:stateorprovince:california
concept:sportsteam:spurs	concept:teamplaysagainstteam	concept:sportsteam:esu_hornets
concept:chemical:gases	concept:chemicalistypeofchemical	concept:chemical:materials
concept:person:mugabe	concept:personleadsgeopoliticalorganization	concept:country:united_states
concept:city:round_rock	concept:subpartof	concept:stateorprovince:texas
concept:agriculturalproduct:plants	concept:agriculturalproducttoattractinsect	concept:insect:mites
concept:fish:parrots	concept:animalpreyson	concept:reptile:pets
concept:stateorprovince:california	concept:mutualproxyfor	concept:city:newport_beach
concept:mammal:foxes	concept:animalistypeofanimal	concept:mammal:mammals
concept:country:__america	concept:countryalsoknownas	concept:country:usa
concept:governmentorganization:house	concept:mutualproxyfor	concept:female:seven
concept:profession:specialists	concept:professionistypeofprofession	concept:profession:project_managers
concept:animal:leopards	concept:specializationof	concept:mammal:animals
concept:city:texas	concept:organizationhiredperson	concept:personmexico:mack_brown
concept:city:montclair	concept:proxyfor	concept:stateorprovince:new_jersey
concept:stateorprovince:california	concept:mutualproxyfor	concept:city:banning
concept:profession:dentists	concept:professionistypeofprofession	concept:profession:staff
concept:city:erie	concept:subpartof	concept:stateorprovince:pennsylvania
concept:sportsequipment:board	concept:mutualproxyfor	concept:recordlabel:guild
concept:sportsteam:dallas_cowboys	concept:teamplaysagainstteam	concept:sportsteam:florida_international
concept:city:dublin_dublin	concept:citylocatedinstate	concept:stateorprovince:california
concept:stateorprovince:california	concept:mutualproxyfor	concept:county:coalinga
concept:county:edison	concept:proxyfor	concept:radiostation:new_jersey
concept:politician:jobs	concept:subpartof	concept:retailstore:apple_computers
concept:governmentorganization:republican_national_committee	concept:organizationhiredperson	concept:personmexico:ryan_whitney
concept:stateorprovince:california	concept:mutualproxyfor	concept:city:baldwin_park
concept:coach:rex_ryan	concept:coachesteam	concept:sportsteam:new_york_jets
concept:lake:new	concept:mutualproxyfor	concept:date:n1977
concept:governmentorganization:amazon_com	concept:agentcontrols	concept:automobilemaker:jeff_bezos
concept:city:service	concept:organizationalsoknownas	concept:governmentorganization:united_states_department
concept:stateorprovince:mississippi	concept:mutualproxyfor	concept:city:hattiesburg
concept:city:rancho_cucamonga	concept:citylocatedinstate	concept:stateorprovince:california
concept:building:glendale	concept:subpartof	concept:beverage:arizona
concept:city:renton	concept:proxyfor	concept:city:washington_d_c
concept:person:andy_reid	concept:worksfor	concept:county:philadelphia
concept:sportsteam:red_sox_this_season	concept:agentcompeteswithagent	concept:personmexico:texas_rangers
concept:profession:professions	concept:professionistypeofprofession	concept:profession:dentists
concept:politician:jobs	concept:agentcontrols	concept:company:pixar
concept:biotechcompany:salt_lake_city	concept:subpartof	concept:county:utah
concept:blog:twitter	concept:competeswith	concept:blog:google
concept:stateorprovince:georgia	concept:mutualproxyfor	concept:county:athens
concept:city:lakewood	concept:proxyfor	concept:stateorprovince:california
concept:city:joliet	concept:proxyfor	concept:stateorprovince:illinois
concept:stateorprovince:california	concept:mutualproxyfor	concept:city:cambria
concept:animal:organisms	concept:animalpreyson	concept:animal:birds002
concept:profession:practitioners	concept:professionistypeofprofession	concept:profession:dietitians
concept:sportsteam:ncaa_youth_kids	concept:agentcompeteswithagent	concept:university:nebraska
concept:profession:individuals	concept:professionistypeofprofession	concept:profession:experts
concept:book:america	concept:synonymfor	concept:city:u__s
concept:mammal:cats	concept:animalistypeofanimal	concept:mammal:mammals
concept:company:pixar	concept:agentcontrols	concept:website:jobs
concept:city:york	concept:proxyfor	concept:stateorprovince:pennsylvania
concept:governmentorganization:intelligence_community	concept:organizationhiredperson	concept:personmexico:ryan_whitney
concept:agriculturalproduct:peppercorns	concept:agriculturalproductcookedwithagriculturalproduct	concept:vegetable:pepper
concept:book:new	concept:mutualproxyfor	concept:visualizableattribute:northern_states
concept:animal:fowl	concept:animalistypeofanimal	concept:mammal:animals
concept:stateorprovince:california	concept:mutualproxyfor	concept:visualizablescene:san_bernadino
concept:city:texas	concept:mutualproxyfor	concept:city:midland
concept:weapon:laws	concept:mutualproxyfor	concept:book:new
concept:city:charlottesville	concept:proxyfor	concept:stateorprovince:virginia
concept:programminglanguage:the_new	concept:atlocation	concept:river:arts
