concept:nongovorganization:legislature	concept:subpartoforganization	concept:organization:the_country
concept:nongovorganization:u_s_	concept:organizationhiredperson	concept:coach:tony_dicicco
concept:sportsteam:georgia_bulldogs	concept:subpartoforganization	concept:sportsteam:ncaa_youth_kids
concept:bedroomitem:new	concept:subpartof	concept:musicsong:louisiana
concept:creditunion:kansas	concept:organizationhiredperson	concept:personaustralia:bill_self
concept:city:guyana	concept:agentbelongstoorganization	concept:sportsleague:mls
concept:university:haverford_college	concept:agentcontrols	concept:book:tim
concept:mountain:fox	concept:agentcollaborateswithagent	concept:politicsblog:geraldo_rivera
concept:university:memphis	concept:subpartoforganization	concept:sportsteam:ncaa_youth_kids
concept:sportsteam:florida_international	concept:organizationhiredperson	concept:coach:john_fox
concept:athlete:joe_flacco	concept:subpartof	concept:sportsteam:ravens
concept:sportsequipment:goal	concept:subpartof	concept:weatherphenomenon:water
concept:buildingfeature:systems	concept:subpartof	concept:chemical:pipes
concept:website:wptv	concept:subpartof	concept:retailstore:nbc
concept:website:netscape	concept:subpartoforganization	concept:blog:america_online
concept:geopoliticallocation:kerry	concept:agentcollaborateswithagent	concept:personus:john_edwards
concept:politicsblog:geraldo_rivera	concept:agentcollaborateswithagent	concept:mountain:fox
concept:blog:google	concept:acquired	concept:company:doubleclick
concept:city:miami_beach	concept:subpartof	concept:city:florida
concept:museum:facilities	concept:subpartof	concept:visualizableattribute:major_water
concept:coach:brett_lee	concept:worksfor	concept:university:uw
concept:coach:tom_coughlin	concept:worksfor	concept:sportsteam:new_york_giants
concept:blog:sun	concept:organizationheadquarteredincity	concept:city:washington_d_c
concept:personmexico:ncaa	concept:agentcontrols	concept:sportsteam:western_kentucky_hilltoppers
concept:personmexico:ncaa	concept:agentcontrols	concept:sportsteam:louisiana_lafayette_ragin_cajuns
concept:coach:rex_ryan	concept:subpartof	concept:sportsleague:new
concept:county:san_francisco	concept:organizationhiredperson	concept:athlete:mike_singletary
concept:recordlabel:dreamworks_skg	concept:organizationterminatedperson	concept:ceo:jeffrey_katzenberg
concept:company:nbc	concept:agentcontrols	concept:televisionstation:kcen
concept:stateorprovince:indiana	concept:organizationhiredperson	concept:coach:terry_hoeppner
concept:room:offices	concept:subpartof	concept:programminglanguage:state
concept:sportsteam:colorado_college	concept:agentcollaborateswithagent	concept:personmexico:ncaa
concept:televisionstation:wand	concept:televisionstationaffiliatedwith	concept:televisionnetwork:nbc_universal
concept:person:mccain	concept:agentcollaborateswithagent	concept:politicianus:democratic_presidential_candidate_barack_obama
concept:bank:administration	concept:subpartof	concept:weatherphenomenon:water
concept:museum:facilities	concept:subpartof	concept:beverage:industrial_water
concept:sportsteam:notre_dame	concept:organizationhiredperson	concept:coach:charlie_weis
concept:personmexico:ncaa	concept:agentcontrols	concept:sportsteam:brown_bears
concept:city:bellevue	concept:subpartof	concept:city:washington_d_c
concept:vehicle:states	concept:subpartof	concept:sportsequipment:northwest
concept:stateorprovince:tennessee	concept:organizationhiredperson	concept:person:lane_kiffin
concept:website:kfor_tv	concept:subpartof	concept:retailstore:nbc
concept:stateorprovince:south_carolina	concept:organizationhiredperson	concept:coach:ron_cooper
concept:sportsteam:minnesota_wilds	concept:agentcollaborateswithagent	concept:athlete:niklas_backstrom
concept:city:san_bernardino	concept:subpartof	concept:stateorprovince:california
concept:programminglanguage:system	concept:subpartof	concept:beverage:central_water
concept:jobposition:agency	concept:subpartof	concept:river:state
concept:celebrity:laura_bush	concept:agentcollaborateswithagent	concept:company:clinton
concept:sportsteam:italy	concept:agentcontrols	concept:personeurope:alessandro_del_piero
concept:bank:bank_america	concept:organizationterminatedperson	concept:ceo:kenneth_lewis
concept:radiostation:nevada	concept:organizationhiredperson	concept:personus:chris_ault
concept:personmexico:ncaa	concept:agentcontrols	concept:sportsteam:arkansas_state_red_wolves
concept:sportsteam:new_england_patriots	concept:organizationhiredperson	concept:coach:carroll
concept:sportsteam:auburn_tigers	concept:subpartoforganization	concept:sportsteam:ncaa_youth_kids
concept:nongovorganization:zanu_pf	concept:agentcollaborateswithagent	concept:person:mugabe
concept:professionalorganization:lions	concept:organizationhiredperson	concept:coach:mariucci
concept:terroristorganization:state	concept:agentcontrols	concept:programminglanguage:process
concept:sportsteam:buccaneers	concept:organizationhiredperson	concept:coach:tony_dungy
concept:governmentorganization:departments	concept:organizationhiredperson	concept:personmexico:ryan_whitney
concept:sportsteam:boise_state_broncos	concept:subpartoforganization	concept:sportsteam:ncaa_youth_kids
concept:university:alabama	concept:organizationhiredperson	concept:coach:mark_gottfried
concept:coach:new	concept:subpartof	concept:aquarium:uk_
concept:website:yahoo_mail	concept:agentcollaborateswithagent	concept:ceo:terry_semel
concept:personmexico:ncaa	concept:agentcontrols	concept:sportsteam:winston_salem_state_rams
concept:televisionnetwork:cbs	concept:agentcollaborateswithagent	concept:journalist:bob_schieffer
concept:sportsteam:boise_state_broncos	concept:organizationhiredperson	concept:coach:chris_petersen
concept:televisionstation:wxii	concept:subpartof	concept:retailstore:nbc
concept:celebrity:gary_williams	concept:agentbelongstoorganization	concept:stateorprovince:maryland
concept:sportsteam:dallas_mavericks	concept:agentcollaborateswithagent	concept:sportsleague:western_conference
concept:university:nebraska	concept:organizationhiredperson	concept:actor:callahan
concept:coach:harbaugh	concept:worksfor	concept:sportsteam:stanford
concept:city:team	concept:agentcollaborateswithagent	concept:politician:jobs
concept:stateorprovince:ole_miss	concept:organizationhiredperson	concept:coach:houston_nutt
concept:personmexico:ncaa	concept:agentcontrols	concept:sportsteam:kansas_state
concept:museum:facilities	concept:subpartof	concept:visualizablething:wastewater
concept:sportsteam:bucs	concept:organizationhiredperson	concept:coach:raheem_morris
concept:person:matt_mullenweg	concept:worksfor	concept:blog:wordpress
concept:vehicle:services	concept:subpartof	concept:musicalbum:us
concept:building:houses	concept:subpartof	concept:weatherphenomenon:water
concept:city:beijing	concept:organizationhiredperson	concept:personmexico:ryan_whitney
concept:coach:bill_lynch	concept:worksfor	concept:stateorprovince:indiana
concept:room:community	concept:subpartof	concept:politicsissue:energy
concept:ceo:frederick_smith	concept:topmemberoforganization	concept:magazine:fedex
concept:city:dallas	concept:organizationhiredperson	concept:coach:sparano
concept:sportsteam:ohio_state_university	concept:subpartoforganization	concept:sportsteam:ncaa_mens_midwest_regionals
concept:county:miami	concept:organizationhiredperson	concept:male:dave_wannstedt
concept:sportsteam:detroit_lions	concept:organizationhiredperson	concept:coach:marty_mornhinweg
concept:sportsteam:texas_a_m	concept:organizationhiredperson	concept:person:sherman
concept:city:gardena	concept:subpartof	concept:stateorprovince:california
concept:personmexico:ncaa	concept:agentcontrols	concept:sportsteam:oral_roberts_golden_eagles
concept:city:summit	concept:organizationhiredperson	concept:personmexico:ryan_whitney
concept:coach:new_york_giants	concept:subpartof	concept:sportsleague:nfl
concept:politician:obama	concept:agentcollaborateswithagent	concept:politicianus:bill_clinton
concept:personmexico:ncaa	concept:agentcontrols	concept:sportsteam:northern_iowa_panthers
concept:politician:jobs	concept:agentcontrols	concept:ceo:eric_schmidt
concept:politicaloffice:wisconsin	concept:subpartof	concept:sportsteam:ncaa_mens_midwest_regionals
concept:sportsteam:rams	concept:organizationhiredperson	concept:coach:scott_linehan
concept:city:home	concept:subpartoforganization	concept:governmentorganization:government
concept:sportsteam:eastern_kentucky_colonels	concept:agentcollaborateswithagent	concept:personmexico:ncaa
concept:publication:syracuse_university	concept:organizationhiredperson	concept:coach:jim_boeheim
concept:beverage:hershey	concept:subpartof	concept:stateorprovince:pennsylvania
concept:personmexico:ncaa	concept:agentcontrols	concept:sportsteam:east_carolina_pirates
concept:sportsteam:new_mexico_state_aggies	concept:subpartoforganization	concept:sportsteam:ncaa_youth_kids
concept:sportsteam:saint_louis_billikens	concept:subpartoforganization	concept:sportsteam:ncaa_youth_kids
concept:company:missouri	concept:companyeconomicsector	concept:economicsector:insurance
concept:sportsteam:lsu	concept:organizationhiredperson	concept:coach:nick_saban
concept:televisionstation:kveo_tv	concept:televisionstationaffiliatedwith	concept:televisionnetwork:nbc_universal
concept:politicianus:democratic_nominee_barack_obama	concept:agentcollaborateswithagent	concept:person:mccain
concept:city:fairchild_air_force_base	concept:organizationhiredperson	concept:coach:fisher_deberry
concept:sportsteam:notre_dame	concept:organizationhiredperson	concept:coach:tyrone_willingham
concept:governmentorganization:government	concept:agentcontrols	concept:scientificterm:statistical_information
concept:visualizablething:measures	concept:subpartof	concept:weatherphenomenon:water
concept:personmexico:ryan_whitney	concept:worksfor	concept:terroristorganization:group
concept:coach:steve_sarkisian	concept:worksfor	concept:city:washington_d_c
concept:stateorprovince:facility	concept:subpartoforganization	concept:terroristorganization:state
concept:company:cnn__pbs	concept:subpartoforganization	concept:bank:viacom
concept:politicsblog:tribune	concept:agentcontrols	concept:politicsblog:wall_street_journal
concept:politician:jobs	concept:agentcontrols	concept:county:newton
concept:personmexico:mack_brown	concept:worksfor	concept:city:texas
concept:personmexico:ncaa	concept:agentcontrols	concept:sportsteam:indiana_hoosiers
concept:politicsblog:tribune	concept:agentcontrols	concept:building:times
concept:city:rio	concept:subpartof	concept:traditionalgame:vegas
concept:personus:ken_lewis	concept:subpartof	concept:book:america
concept:city:team	concept:organizationhiredperson	concept:writer:brown
concept:coach:steve_spagnuolo	concept:worksfor	concept:city:st_louis
concept:sportsteam:arizona_cardinals_27_23	concept:organizationhiredperson	concept:coach:ken_whisenhunt
concept:stateorprovince:connecticut	concept:organizationterminatedperson	concept:coach:randy_edsall
concept:university:usc	concept:organizationhiredperson	concept:coach:steve_spurrier
concept:city:resources	concept:agentcollaborateswithagent	concept:person:state
concept:country:liberia	concept:agentbelongstoorganization	concept:sportsleague:mls
concept:company:charleston	concept:subpartof	concept:company:west_virginia
concept:televisionnetwork:cbs	concept:agentcollaborateswithagent	concept:journalist:dan_rather
concept:country:__america	concept:organizationterminatedperson	concept:scientist:no_
concept:ceo:andy_grove	concept:worksfor	concept:company:intel
concept:sportsteam:umass_lowell_river_hawks	concept:subpartoforganization	concept:sportsteam:ncaa_mens_midwest_regionals
concept:company:north_carolina	concept:organizationhiredperson	concept:coach:john_bunting
concept:athlete:paul_brown	concept:worksfor	concept:sportsteam:eagles
concept:sportsteam:new_england_patriots	concept:organizationhiredperson	concept:person:belichick
concept:sportsteam:houston_cougars	concept:agentcollaborateswithagent	concept:personmexico:ncaa
concept:bank:viacom	concept:organizationterminatedperson	concept:ceo:sumner_redstone
concept:coach:alabama_crimson_tide	concept:agentbelongstoorganization	concept:sportsteam:ncaa_youth_kids
concept:televisionstation:kbjr_tv	concept:televisionstationaffiliatedwith	concept:televisionnetwork:nbc_universal
concept:personmexico:ncaa	concept:agentcontrols	concept:sportsteam:pittsburg_state_gorillas
concept:creditunion:kansas	concept:subpartoforganization	concept:sportsteam:ncaa_youth_kids
concept:personmexico:ryan_whitney	concept:worksfor	concept:geopoliticallocation:agencies
concept:company:nebraska	concept:companyeconomicsector	concept:economicsector:insurance_coverage
concept:sportsteam:texas_christian	concept:subpartoforganization	concept:sportsteam:ncaa_youth_kids
concept:sportsleague:new	concept:organizationhiredperson	concept:coach:sean_payton
concept:sportsteam:oklahoma_state_cowboys	concept:agentcollaborateswithagent	concept:personmexico:ncaa
concept:university:uab	concept:organizationhiredperson	concept:person:davis
concept:city:sources	concept:subpartoforganization	concept:governmentorganization:department
concept:company:general_motors	concept:companyeconomicsector	concept:economicsector:automobile
concept:coach:new	concept:subpartof	concept:sportsleague:terms
concept:website:sydney_morning_herald	concept:agentcollaborateswithagent	concept:journalist:paul_sheehan
concept:coach:philip_fulmer	concept:worksfor	concept:sportsteam:vols
concept:governmentorganization:government	concept:agentcontrols	concept:website:statistics
concept:newspaper:financial_times	concept:headquarteredin	concept:city:london_city
concept:county:las_vegas	concept:subpartof	concept:traditionalgame:vegas
concept:televisionstation:wvtm_tv	concept:subpartof	concept:retailstore:nbc
concept:terroristorganization:state	concept:agentcontrols	concept:website:resources
concept:governmentorganization:epa	concept:organizationhiredperson	concept:personmexico:ryan_whitney
concept:company:pixar	concept:agentcollaborateswithagent	concept:personaustralia:jobs
concept:website:wsls_tv	concept:subpartof	concept:retailstore:nbc
concept:personmexico:ncaa	concept:agentcontrols	concept:sportsteam:saint_louis_billikens
concept:vehicle:states	concept:subpartof	concept:airport:europe
concept:male:world	concept:agentcontrols	concept:candy:john
concept:male:world	concept:agentcollaborateswithagent	concept:person:stephen
concept:coach:greg_robinson	concept:worksfor	concept:musicartist:orange
concept:university:purdue	concept:subpartoforganization	concept:sportsteam:ncaa_mens_midwest_regionals
concept:person:mccain	concept:agentcollaborateswithagent	concept:politicianus:mr__obama
concept:city:berkeley	concept:subpartof	concept:stateorprovince:california
concept:terroristorganization:state	concept:agentcontrols	concept:sport:initiatives
concept:journalist:charles_osgood	concept:worksfor	concept:televisionnetwork:cbs
concept:personmexico:ncaa	concept:agentcontrols	concept:sportsteam:oregon_ducks
concept:musicartist:journal	concept:agentcontrols	concept:company:bloomberg001
concept:city:deerfield_beach	concept:subpartof	concept:city:florida
concept:city:home	concept:agentbelongstoorganization	concept:stateorprovince:contact
concept:buildingfeature:systems	concept:subpartof	concept:visualizableattribute:two_water
concept:city:chapel_hill	concept:subpartof	concept:creditunion:north_carolina
concept:female:yankees	concept:agentcollaborateswithagent	concept:politicianus:austin_jackson
concept:sportsteam:duke_blue_devils	concept:agentcollaborateswithagent	concept:personmexico:ncaa
concept:biotechcompany:gateway_2000	concept:subpartoforganization	concept:company:acer_aspire
concept:coach:philip_fulmer	concept:subpartof	concept:astronaut:vols
concept:website:technorati	concept:organizationhiredperson	concept:ceo:david_sifry
concept:sportsteam:wichita_state	concept:subpartoforganization	concept:sportsteam:ncaa_youth_kids
concept:city:pictures	concept:subpartof	concept:weatherphenomenon:air
concept:buildingfeature:systems	concept:subpartof	concept:visualizableattribute:storm_water
concept:sportsteam:jaguars	concept:organizationhiredperson	concept:coach:tom_coughlin
concept:programminglanguage:services	concept:subpartof	concept:visualizableattribute:drinking_water
concept:sportsleague:syracuse	concept:subpartoforganization	concept:sportsteam:ncaa_youth_kids
concept:country:united_states	concept:organizationhiredperson	concept:personmexico:ryan_whitney
concept:personmexico:ncaa	concept:agentcontrols	concept:sportsteam:rutgers_scarlet_knights
concept:governmentorganization:government	concept:agentcontrols	concept:vehicle:benefits
concept:terroristorganization:money	concept:agentbelongstoorganization	concept:politicalparty:federal_government
concept:county:brooklyn	concept:subpartof	concept:city:york
concept:politicsissue:programs	concept:subpartof	concept:visualizableattribute:various_water
concept:personmexico:ncaa	concept:agentcontrols	concept:sportsteam:colorado_buffaloes
concept:coach:raymond_james_stadium	concept:subpartof	concept:city:tampa_bay
concept:radiostation:beaumont	concept:subpartof	concept:city:texas
concept:city:westminster	concept:subpartof	concept:stateorprovince:california
concept:journalist:thomas_friedman	concept:worksfor	concept:company:york_times
concept:geopoliticallocation:bolton	concept:organizationhiredperson	concept:personmexico:ryan_whitney
concept:musicartist:times	concept:agentcollaborateswithagent	concept:bird:frank_rich
concept:bedroomitem:system	concept:subpartof	concept:kitchenitem:public_water
concept:sportsteam:tennessee_state_tigers	concept:agentcollaborateswithagent	concept:personmexico:ncaa
concept:stateorprovince:wyoming	concept:organizationhiredperson	concept:personmexico:frank_robinson
concept:buildingfeature:systems	concept:subpartof	concept:visualizablething:effective_water
concept:sportsleague:new	concept:organizationhiredperson	concept:coach:steve_spagnuolo
concept:city:washington_d_c	concept:subpartoforganization	concept:sportsteam:ncaa_mens_midwest_regionals
concept:retailstore:consumers	concept:subpartof	concept:weatherphenomenon:air
concept:geopoliticallocation:anderson	concept:subpartof	concept:stateorprovince:indiana
concept:city:service	concept:subpartof	concept:retailstore:aapl
concept:biotechcompany:gateway_2000	concept:organizationhiredperson	concept:ceo:ted_waitt
concept:governmentorganization:defense_department	concept:organizationhiredperson	concept:personmexico:ryan_whitney
concept:politicsblog:amazon_com	concept:organizationheadquarteredincity	concept:city:seattle
concept:company:nbc	concept:agentcontrols	concept:website:wmc
concept:vehicle:research	concept:subpartof	concept:weatherphenomenon:air
concept:room:community	concept:subpartof	concept:hallwayitem:gas
concept:coach:jon_gruden	concept:worksfor	concept:sportsteam:buccaneers
concept:eventoutcome:rights	concept:subpartof	concept:weatherphenomenon:water
concept:sportsteam:elon_phoenix	concept:subpartoforganization	concept:sportsteam:ncaa_youth_kids
concept:politician:david_brooks	concept:agentcollaborateswithagent	concept:musicartist:times
concept:politician:barack_hussein_obama	concept:agentcollaborateswithagent	concept:politician:clinton
concept:sportsteam:weber_state_wildcats	concept:agentcollaborateswithagent	concept:personmexico:ncaa
concept:company:disney	concept:acquired	concept:company:pixar
concept:sportsteam:bulldogs	concept:organizationhiredperson	concept:coach:dennis_felton
concept:room:house	concept:subpartof	concept:beverage:tankless_water
concept:personmexico:ncaa	concept:agentcontrols	concept:sportsteam:northern_colorado_bears
concept:city:baghdad	concept:organizationhiredperson	concept:personmexico:ryan_whitney
concept:automobilemaker:dallas_cowboys	concept:organizationhiredperson	concept:musician:jimmy_johnson
concept:person:state	concept:agentcontrols	concept:governmentorganization:regulatory_agencies
concept:sportsleague:new	concept:organizationhiredperson	concept:coach:spagnuolo
concept:sportsteam:boston_terriers	concept:agentcollaborateswithagent	concept:personmexico:ncaa
concept:county:miami	concept:organizationhiredperson	concept:coach:nick_saban
concept:sportsteam:nevada_wolfpack	concept:organizationhiredperson	concept:coach:chuck_amato
concept:transportation:network	concept:subpartof	concept:weatherphenomenon:water
concept:politician:jobs	concept:agentcontrols	concept:videogamesystem:ipod
concept:sportsleague:nba	concept:agentcontrols	concept:coach:new_orleans_hornets
concept:coach:carroll	concept:worksfor	concept:university:usc
concept:politicalparty:democrats	concept:agentbelongstoorganization	concept:governmentorganization:house
concept:city:bush	concept:agentcollaborateswithagent	concept:governmentorganization:house
concept:website:concord	concept:subpartof	concept:company:north_carolina
concept:city:pittsburgh	concept:organizationhiredperson	concept:coach:cowher
concept:stateorprovince:author	concept:agentcollaborateswithagent	concept:male:world
concept:politician:jobs	concept:worksfor	concept:website:technology
concept:person:larry_ellison	concept:agentcontrols	concept:perceptionaction:oracle_corporation
concept:company:post	concept:organizationheadquarteredincity	concept:county:los_angeles_county
concept:sportsteam:reds	concept:agentcontrols	concept:person:ken_griffey_jr
concept:sportsteam:florida_gators	concept:organizationhiredperson	concept:visualartist:meyer
concept:sportsteam:akron_pros	concept:organizationhiredperson	concept:coach:j_d__brookhart
concept:sportsteam:mississippi_rebels	concept:subpartoforganization	concept:sportsteam:ncaa_youth_kids
concept:male:world	concept:agentcontrols	concept:person:greg001
concept:personus:jann_wenner	concept:worksfor	concept:website:rolling_stone_magazine
concept:room:house	concept:subpartof	concept:beverage:solar_water
concept:nonprofitorganization:operations	concept:organizationhiredperson	concept:personmexico:ryan_whitney
concept:university:butler	concept:subpartoforganization	concept:sportsteam:ncaa_youth_kids
concept:city:wellington	concept:subpartof	concept:country:new_zealand
concept:televisionstation:wxii	concept:televisionstationaffiliatedwith	concept:televisionnetwork:nbc_universal
concept:blog:myspace	concept:subpartoforganization	concept:company:news_corp_
concept:scientist:paypal	concept:agentcollaborateswithagent	concept:ceo:peter_thiel
concept:company:new_york	concept:organizationterminatedperson	concept:scientist:no_
concept:terroristorganization:state	concept:agentcontrols	concept:landscapefeatures:steps
concept:newspaper:kgw_tv	concept:subpartof	concept:retailstore:nbc
concept:judge:mr_	concept:agentcollaborateswithagent	concept:person:house
concept:stateorprovince:minnesota	concept:organizationhiredperson	concept:coach:dennis_green
concept:politicianus:joe_biden	concept:agentcollaborateswithagent	concept:politician:obama
concept:city:muncie	concept:subpartof	concept:stateorprovince:indiana
concept:city:kennewick	concept:subpartof	concept:city:washington_d_c
concept:programminglanguage:system	concept:subpartof	concept:beverage:industrial_air
concept:city:team	concept:agentcontrols	concept:museum:steve
concept:perceptionaction:davenport	concept:subpartof	concept:musicalbum:iowa
concept:radiostation:cleveland	concept:organizationhiredperson	concept:coach:eric_mangini
concept:politicsblog:amazon_com	concept:headquarteredin	concept:city:seattle
concept:county:manhattan	concept:subpartof	concept:company:new_york
concept:coach:gene_chizik	concept:agentbelongstoorganization	concept:stateorprovince:auburn
concept:person:john003	concept:worksfor	concept:politicsblog:ny_times
concept:person:mccain	concept:agentcollaborateswithagent	concept:writer:barak_obama
concept:website:ksaz_tv	concept:subpartof	concept:mountain:fox
concept:company:ap_001	concept:headquarteredin	concept:city:washington_d_c
concept:transportation:concerns	concept:subpartof	concept:weatherphenomenon:air
concept:biotechcompany:fast	concept:companyeconomicsector	concept:economicsector:insurance
concept:ceo:ted_waitt	concept:worksfor	concept:biotechcompany:gateway_2000
concept:coach:kansas_state	concept:agentcontrols	concept:coach:bill_snyder
concept:city:port_arthur	concept:subpartof	concept:stateorprovince:texas
concept:sportsteam:oregon_state_beavers	concept:organizationhiredperson	concept:person:riley001
concept:politician:jobs	concept:worksfor	concept:city:design
concept:sportsteam:ncaa_youth_kids	concept:agentcontrols	concept:coach:mississippi_state_bulldogs
concept:blog:today	concept:organizationhiredperson	concept:personmexico:ryan_whitney
concept:actor:chris_wallace	concept:worksfor	concept:mountain:fox
concept:room:community	concept:subpartof	concept:room:plumbing
concept:room:development	concept:subpartof	concept:politicsissue:energy
concept:personus:thomas_jefferson	concept:agentcollaborateswithagent	concept:city:bush
concept:company:nbc	concept:agentcontrols	concept:televisionstation:wsav_tv
concept:person:phil_jackson	concept:worksfor	concept:sportsteam:chicago_bulls
concept:person:republican	concept:agentcontrols	concept:coach:sarah_palin
concept:politician:jobs	concept:agentcontrols	concept:person:macintosh
concept:sportsteam:boston_college	concept:organizationhiredperson	concept:person:al_skinner
concept:terroristorganization:state	concept:agentcontrols	concept:emotion:lands
concept:university:message	concept:organizationhiredperson	concept:personmexico:ryan_whitney
concept:newspaper:jane	concept:agentcollaborateswithagent	concept:male:world
concept:mountain:fox	concept:agentcontrols	concept:website:koki_tv
concept:televisionstation:wwbt	concept:subpartof	concept:retailstore:nbc
concept:profession:installers	concept:subpartof	concept:weatherphenomenon:water
concept:sportsteam:boise_state_broncos	concept:agentcollaborateswithagent	concept:personmexico:ncaa
concept:county:columbus	concept:subpartof	concept:university:ohio
concept:politicianus:hillary_clinton	concept:agentcollaborateswithagent	concept:politician:obama
concept:coach:new	concept:subpartof	concept:director:summers
concept:company:nbc	concept:agentcollaborateswithagent	concept:person:tim_russert
concept:website:new_york_times	concept:organizationhiredperson	concept:personmexico:ryan_whitney
concept:room:level	concept:subpartof	concept:weatherphenomenon:air
concept:coach:hayden_fry	concept:worksfor	concept:blog:iowa
concept:biotechcompany:white	concept:agentbelongstoorganization	concept:bank:administration
concept:buildingfeature:systems	concept:subpartof	concept:book:electricity
concept:athlete:fred_smith	concept:worksfor	concept:magazine:fedex
concept:sportsteam:ncaa_youth_kids	concept:agentcontrols	concept:celebrity:seton_hall_pirates
concept:university:google	concept:organizationterminatedperson	concept:scientist:no_
concept:personmexico:ryan_whitney	concept:worksfor	concept:terroristorganization:operation
concept:stateorprovince:tennessee	concept:organizationhiredperson	concept:coach:pat_summitt
concept:book:new	concept:subpartof	concept:politicsissue:residents
concept:university:purdue	concept:organizationhiredperson	concept:personmexico:matt_painter
concept:sportsteam:emory_eagles	concept:subpartoforganization	concept:sportsteam:ncaa_youth_kids
concept:hallwayitem:connection	concept:subpartof	concept:weatherphenomenon:water
concept:geopoliticallocation:option	concept:subpartof	concept:vehicle:air
concept:sportsequipment:officials	concept:subpartof	concept:weatherphenomenon:water
concept:mlconference:services_website	concept:subpartof	concept:city:texas
concept:politician:jobs	concept:agentcollaborateswithagent	concept:male:world
concept:coach:vince_lombardi	concept:worksfor	concept:sportsteam:packers
concept:company:west_virginia	concept:subpartoforganization	concept:sportsteam:ncaa_mens_midwest_regionals
concept:coach:new	concept:subpartof	concept:musicinstrument:blocks
concept:governmentorganization:united_states_congress	concept:organizationhiredperson	concept:personmexico:ryan_whitney
concept:personmexico:ncaa	concept:agentcontrols	concept:sportsteam:ohio_state_buckeyes
concept:sportsteam:dallas_mavericks	concept:organizationhiredperson	concept:personaustralia:avery_johnson
concept:radiostation:canton	concept:subpartof	concept:creditunion:michigan
concept:sportsteam:pittsburgh_penguins	concept:organizationhiredperson	concept:coach:therrien
concept:musicartist:journal	concept:agentcontrols	concept:hotel:fortune
concept:stateorprovince:virginia	concept:organizationhiredperson	concept:professor:terry_holland
concept:website:inktomi	concept:subpartoforganization	concept:university:yahoo
concept:person:mccain	concept:agentcollaborateswithagent	concept:politicianus:presidential_candidate_barack_obama
concept:company:hp	concept:companyeconomicsector	concept:academicfield:information_technology
concept:personmexico:ncaa	concept:agentcontrols	concept:sportsteam:penn_state_nittany_lions
concept:mlalgorithm:solutions	concept:subpartof	concept:weatherphenomenon:water
concept:stateorprovince:indiana	concept:agentcontrols	concept:personafrica:mike_davis
concept:company:nbc	concept:agentcontrols	concept:televisionstation:wmaq
concept:politicsblog:kpnx_tv	concept:agentcollaborateswithagent	concept:company:nbc
concept:sportsteam:new_york_jets	concept:organizationhiredperson	concept:person:edwards
concept:coach:carolina_panthers	concept:agentbelongstoorganization	concept:sportsleague:nfl
concept:person:john003	concept:worksfor	concept:company:the_new_york_times001
concept:buildingfeature:systems	concept:subpartof	concept:visualizableattribute:elaborate_water
concept:company:nbc	concept:agentcontrols	concept:televisionstation:ksnt_tv
concept:stateorprovince:mississippi_state	concept:subpartoforganization	concept:sportsteam:ncaa_mens_midwest_regionals
concept:geometricshape:queens	concept:subpartof	concept:company:new_york
concept:sportsteam:cleveland_state_vikings	concept:subpartoforganization	concept:sportsteam:ncaa_youth_kids
concept:televisionstation:wtwo	concept:subpartof	concept:retailstore:nbc
concept:sportsteam:redskins	concept:organizationhiredperson	concept:coach:steve_spurrier
concept:biotechcompany:white	concept:agentcollaborateswithagent	concept:city:team
concept:sportsteam:georgetown_hoyas	concept:subpartoforganization	concept:sportsteam:ncaa_youth_kids
concept:coach:new	concept:subpartof	concept:sportsteam:uk
concept:musician:agencies	concept:agentbelongstoorganization	concept:terroristorganization:state
concept:company:intel	concept:acquired	concept:company:dialogic
concept:skiarea:farmington	concept:subpartof	concept:county:new_mexico
concept:personmexico:ncaa	concept:agentcontrols	concept:sportsteam:syracuse_orangemen
concept:blog:linkedin	concept:companyeconomicsector	concept:economicsector:social_networking
concept:coach:bob_bradley	concept:worksfor	concept:nongovorganization:u_s_
concept:person:don_shula	concept:worksfor	concept:sportsteam:miami_dolphins
concept:personmexico:ncaa	concept:agentcontrols	concept:sportsteam:eastern_illinois_panthers
concept:televisionnetwork:cbs	concept:agentcontrols	concept:televisionstation:wsaw
concept:personus:john_edwards	concept:agentcollaborateswithagent	concept:geopoliticallocation:kerry
concept:governmentorganization:government	concept:agentcontrols	concept:emotion:land
concept:musicartist:journal	concept:agentcontrols	concept:city:l_a_
concept:city:bloomington	concept:subpartof	concept:stateorprovince:indiana
concept:company:ebay001	concept:organizationheadquarteredincity	concept:city:san_jose
concept:stateorprovince:georgia	concept:subpartoforganization	concept:sportsteam:ncaa_youth_kids
concept:city:cookeville	concept:subpartof	concept:weatherphenomenon:tennessee
concept:mountain:fox	concept:agentcollaborateswithagent	concept:blog:bill_o_reilly
concept:buildingfeature:service	concept:subpartof	concept:visualizableattribute:drinking_water
concept:geopoliticallocation:world	concept:organizationhiredperson	concept:personmexico:ryan_whitney
concept:televisionstation:wwbt	concept:televisionstationaffiliatedwith	concept:televisionnetwork:nbc_universal
concept:nongovorganization:u_s_	concept:organizationhiredperson	concept:coach:greg_ryan
concept:televisionstation:kobi	concept:subpartoforganization	concept:televisionnetwork:nbc_universal
concept:coach:douglas_edwards	concept:agentbelongstoorganization	concept:televisionnetwork:cbs
concept:building:outlet	concept:subpartof	concept:weatherphenomenon:water
concept:city:louisville	concept:organizationhiredperson	concept:coach:petrino
concept:newspaper:wics_tv	concept:subpartof	concept:retailstore:nbc
concept:sportsteam:oregon_ducks	concept:subpartoforganization	concept:sportsteam:ncaa_youth_kids
concept:coach:tressel	concept:worksfor	concept:sportsteam:ohio_state_university
concept:city:orange	concept:organizationhiredperson	concept:visualizablescene:robinson
concept:geopoliticallocation:agencies	concept:subpartoforganization	concept:sportsteam:universities
concept:buildingfeature:systems	concept:subpartof	concept:visualizableattribute:potable_water
concept:university:alabama	concept:organizationhiredperson	concept:coach:bear_bryant
concept:company:sun_microsystems001	concept:companyeconomicsector	concept:economicsector:computer
concept:company:nbc	concept:agentcontrols	concept:televisionstation:wnyt_tv
concept:company:nbc	concept:agentcontrols	concept:televisionstation:kcfw_tv
concept:company:hp	concept:organizationheadquarteredincity	concept:city:palo_alto
concept:city:tampa_bay	concept:organizationhiredperson	concept:athlete:john_tortorella
concept:vehicle:states	concept:subpartof	concept:room:community
concept:mountain:fox	concept:agentcontrols	concept:website:waws_tv
concept:country:vatican	concept:organizationhiredperson	concept:personmexico:ryan_whitney
concept:person:mccain	concept:agentcollaborateswithagent	concept:politician:w__bush
concept:televisionstation:wdsu_tv	concept:subpartof	concept:retailstore:nbc
concept:televisionstation:kmoh	concept:subpartoforganization	concept:televisionnetwork:nbc_universal
concept:company:nbc	concept:agentcontrols	concept:televisionstation:ktuu
concept:creditunion:michigan	concept:organizationhiredperson	concept:coach:beilein
concept:geopoliticallocation:authorities	concept:subpartof	concept:beverage:local_water
concept:sportsteam:former_san_francisco_giants	concept:agentcollaborateswithagent	concept:athlete:bonds
concept:sportsteam:knicks	concept:organizationhiredperson	concept:person:pat_riley
concept:coach:tomlin	concept:worksfor	concept:sportsteam:steelers
concept:politician:michael_nutter	concept:worksfor	concept:county:philadelphia
concept:televisionstation:kndu	concept:televisionstationaffiliatedwith	concept:televisionnetwork:nbc_universal
concept:company:doubleclick	concept:companyeconomicsector	concept:economicsector:online_advertising
concept:sportsteam:arizona_cardinals_27_23	concept:organizationhiredperson	concept:coach:todd_haley
concept:company:nbc	concept:agentcontrols	concept:website:walb_tv
concept:coach:jim_caldwell	concept:worksfor	concept:sportsteam:colts
concept:coach:sparano	concept:worksfor	concept:musicartist:season
concept:sportsteam:george_washington_colonials	concept:subpartoforganization	concept:sportsteam:ncaa_youth_kids
concept:biotechcompany:white	concept:agentbelongstoorganization	concept:governmentorganization:house
concept:sportsteam:oklahoma_state_cowboys	concept:subpartoforganization	concept:sportsteam:ncaa_youth_kids
concept:company:general_motors001	concept:organizationterminatedperson	concept:ceo:fritz_henderson
concept:publication:wsaz_tv	concept:subpartof	concept:retailstore:nbc
concept:politicianus:dick_cheney	concept:agentbelongstoorganization	concept:politicalparty:house
concept:governmentorganization:government	concept:agentcontrols	concept:vehicle:research
concept:profession:managers	concept:subpartof	concept:weatherphenomenon:water
concept:musicartist:policy	concept:agentcontrols	concept:clothing:white
concept:sportsteam:seminoles	concept:organizationhiredperson	concept:male:bobby_bowden
concept:personmexico:ncaa	concept:agentcontrols	concept:sportsteam:elon_phoenix
concept:sportsteam:alabama_crimson_tide	concept:subpartoforganization	concept:sportsteam:ncaa_mens_midwest_regionals
concept:televisionstation:wicd	concept:subpartoforganization	concept:televisionnetwork:nbc_universal
concept:sportsteam:suns	concept:organizationhiredperson	concept:personmexico:steve_nash
concept:coach:new_york_jets	concept:subpartof	concept:sportsleague:nfl
concept:shoppingmall:asheville	concept:subpartof	concept:creditunion:north_carolina
concept:city:princeton	concept:organizationhiredperson	concept:coach:bill_tierney
concept:company:sun	concept:headquarteredin	concept:city:washington_d_c
concept:person:edwards	concept:agentcollaborateswithagent	concept:female:hillary
concept:automobilemaker:jeff_bezos	concept:agentcontrols	concept:governmentorganization:amazon_com
concept:sportsteam:florida_state_seminoles	concept:subpartoforganization	concept:sportsteam:ncaa_youth_kids
concept:politicianus:john_kerry	concept:agentcollaborateswithagent	concept:politician:obama
concept:biotechcompany:china	concept:companyeconomicsector	concept:economicsector:insurance
concept:company:power	concept:organizationhiredperson	concept:personmexico:ryan_whitney
concept:sportsteam:pistons	concept:organizationhiredperson	concept:coach:richard_hamilton
concept:county:chicago	concept:organizationhiredperson	concept:coach:dick_jauron
concept:city:ontario	concept:subpartof	concept:stateorprovince:california
concept:sportsteam:nebraska_cornhuskers	concept:subpartoforganization	concept:sportsteam:ncaa_youth_kids
concept:company:case	concept:agentbelongstoorganization	concept:blog:america_online
concept:politician:sheila_dixon	concept:worksfor	concept:county:baltimore
concept:stateorprovince:michigan	concept:organizationhiredperson	concept:politicianus:john_engler
concept:museum:facilities	concept:subpartof	concept:visualizablething:water_supply
concept:company:walt_disney_world	concept:organizationheadquarteredincity	concept:city:burbank
concept:sportsequipment:board	concept:subpartof	concept:weatherphenomenon:water
concept:sportsteam:louisville_cardinals	concept:agentcollaborateswithagent	concept:personmexico:ncaa
concept:sportsteam:bears_29_17	concept:organizationhiredperson	concept:coach:mike_ditka
concept:company:nbc	concept:agentcontrols	concept:website:kvoa
concept:sportsteam:broncos	concept:organizationhiredperson	concept:athlete:jeremy_bates
concept:sportsteam:boston_college	concept:organizationhiredperson	concept:coach:jagodzinski
concept:coach:miami_dolphins	concept:subpartof	concept:sportsleague:nfl
concept:sportsteam:eastern_michigan_eagles	concept:agentcollaborateswithagent	concept:personmexico:ncaa
concept:university:microsoft	concept:agentcollaborateswithagent	concept:personus:steve_ballmer
concept:city:washington_d_c	concept:organizationterminatedperson	concept:person:ty_willingham
concept:sportsteam:new_orleans_hornets	concept:organizationhiredperson	concept:coach:byron_scott
concept:website:tacoda	concept:subpartof	concept:mldataset:aol
concept:university:uf	concept:organizationhiredperson	concept:visualartist:meyer
concept:sportsteam:detroit_lions	concept:organizationhiredperson	concept:coach:mariucci
concept:journalist:maureen_dowd	concept:worksfor	concept:musicartist:times
concept:country:australia	concept:organizationhiredperson	concept:professor:john_howard
concept:automobilemaker:jeff_bezos	concept:agentcontrols	concept:museum:steve
concept:sportsteam:sacramento_kings	concept:organizationhiredperson	concept:coach:reggie_theus
concept:hallwayitem:areas	concept:subpartof	concept:weatherphenomenon:water
concept:stateorprovince:minnesota	concept:organizationhiredperson	concept:coach:herb_brooks
concept:geopoliticallocation:authorities	concept:subpartof	concept:river:state
concept:coach:bill_tierney	concept:worksfor	concept:city:princeton
concept:personmexico:ncaa	concept:agentcontrols	concept:sportsteam:central_florida_knights
concept:stateorprovince:tennessee	concept:organizationhiredperson	concept:coach:philip_fulmer
concept:sportsteam:man_utd	concept:organizationhiredperson	concept:personmexico:alex_ferguson
concept:sportsleague:new	concept:organizationhiredperson	concept:coach:jim_schwartz
concept:county:paris	concept:subpartof	concept:traditionalgame:vegas
concept:politicsblog:amazon_com	concept:acquired	concept:company:junglee
concept:city:fredericksburg	concept:subpartof	concept:stateorprovince:virginia
concept:city:portsmouth	concept:subpartof	concept:stateorprovince:virginia
concept:website:netscape	concept:subpartoforganization	concept:company:aol_
concept:sportsteam:minnesota_duluth_bulldogs	concept:agentcollaborateswithagent	concept:personmexico:ncaa
concept:personmexico:ryan_whitney	concept:worksfor	concept:politicalparty:republican_party
concept:sportsteam:charlotte_49ers	concept:subpartoforganization	concept:sportsteam:ncaa_youth_kids
concept:politicsissue:programs	concept:subpartof	concept:visualizableattribute:drinking_water
concept:coach:new_orleans_saints	concept:agentcollaborateswithagent	concept:sportsleague:nfl
concept:governmentorganization:federal_agencies	concept:organizationhiredperson	concept:personmexico:ryan_whitney
concept:sportsteam:valparaiso_crusaders	concept:agentcollaborateswithagent	concept:personmexico:ncaa
concept:company:clinton	concept:agentcontrols	concept:clothing:white
concept:televisionstation:wmgt	concept:televisionstationaffiliatedwith	concept:televisionnetwork:nbc_universal
concept:sportsteam:uc_santa_barbara_gauchos	concept:subpartoforganization	concept:sportsteam:ncaa_youth_kids
concept:sportsteam:fresno_state_bulldogs	concept:agentcollaborateswithagent	concept:personmexico:ncaa
concept:politician:jobs	concept:worksfor	concept:recordlabel:walt_disney
concept:sportsteam:east_carolina_pirates	concept:agentcollaborateswithagent	concept:personmexico:ncaa
concept:mountain:fox	concept:agentcollaborateswithagent	concept:person:brit_hume
concept:company:nbc	concept:companyeconomicsector	concept:academicfield:programming
concept:website:bill	concept:subpartof	concept:weatherphenomenon:air
concept:city:cincinnati	concept:organizationhiredperson	concept:coach:brian_kelly
concept:ceo:brian_moynihan	concept:worksfor	concept:bank:bank_america
concept:televisionnetwork:cbs	concept:agentcollaborateswithagent	concept:person:les_moonves
concept:sportsteam:cavaliers	concept:organizationhiredperson	concept:writer:brown
concept:ceo:andrea_jung	concept:topmemberoforganization	concept:biotechcompany:avon
concept:politician:obama	concept:agentcollaborateswithagent	concept:personus:hilary_rodham_clinton
concept:televisionstation:knop_tv	concept:subpartof	concept:retailstore:nbc
concept:sportsteam:uk	concept:organizationhiredperson	concept:personmexico:billy_gillispie
concept:politicsblog:tribune	concept:headquarteredin	concept:city:washington_d_c
concept:personaustralia:avery_johnson	concept:worksfor	concept:city:dallas
concept:university:southern_cal	concept:subpartoforganization	concept:sportsteam:ncaa_youth_kids
concept:university:administration	concept:agentcontrols	concept:person:mugabe
concept:company:new_york	concept:agentcontrols	concept:vehicle:services
concept:city:melbourne	concept:subpartof	concept:city:florida
concept:televisionnetwork:cbs	concept:agentcontrols	concept:televisionstation:whbf
concept:televisionstation:wrcb_tv	concept:subpartof	concept:retailstore:nbc
concept:governmentorganization:regulatory_agencies	concept:subpartoforganization	concept:terroristorganization:state
concept:personnorthamerica:john_mccain	concept:agentcollaborateswithagent	concept:politician:w__bush
concept:televisionstation:wnyt_tv	concept:subpartof	concept:retailstore:nbc
concept:coach:jack_del_rio	concept:worksfor	concept:city:jacksonville
concept:politician:jobs	concept:agentcontrols	concept:city:team
concept:sportsteam:mississippi_valley_state_delta_devils	concept:subpartoforganization	concept:sportsteam:ncaa_youth_kids
concept:sportsleague:new	concept:organizationhiredperson	concept:coach:bill_parcells
concept:sportsteam:brown_bears	concept:agentcollaborateswithagent	concept:personmexico:ncaa
concept:programminglanguage:system	concept:subpartof	concept:beverage:efficient_water
concept:stateorprovince:indiana	concept:organizationhiredperson	concept:coach:tom_crean
concept:televisionstation:kark_tv	concept:organizationheadquarteredincity	concept:city:little_rock
concept:personus:thomas_steen	concept:worksfor	concept:university:butler
concept:bank:dhl	concept:acquired	concept:bank:airborne
concept:creditunion:wisconsin	concept:subpartoforganization	concept:sportsteam:ncaa_mens_midwest_regionals
concept:sportsteam:butler_bulldogs	concept:subpartoforganization	concept:sportsteam:ncaa_youth_kids
concept:company:aol	concept:companyeconomicsector	concept:economicsector:internet
concept:book:new	concept:subpartof	concept:politicsissue:markets
concept:sportsteam:leafs	concept:organizationhiredperson	concept:coach:al_arbour
concept:person:mccain	concept:agentcollaborateswithagent	concept:newspaper:president_elect_barack_obama
concept:sportsteam:sacred_heart_pioneers	concept:agentcollaborateswithagent	concept:personmexico:ncaa
concept:company:nbc	concept:agentcontrols	concept:televisionstation:wtwo
concept:personmexico:colorado_rockies	concept:subpartof	concept:sportsleague:mlb
concept:city:father	concept:agentbelongstoorganization	concept:politicalparty:house
concept:politician:jobs	concept:agentcontrols	concept:charactertrait:world
concept:person:andy_reid	concept:worksfor	concept:county:philadelphia
concept:company:nbc	concept:agentcontrols	concept:televisionstation:ksnw_tv
concept:city:springfield	concept:subpartof	concept:stateorprovince:virginia
concept:country:moldova	concept:subpartof	concept:vehicle:countries
concept:politicianus:john_edwards	concept:agentcollaborateswithagent	concept:politician:obama
concept:personus:jason_giambi	concept:subpartof	concept:sportsleague:new
concept:buildingfeature:home	concept:subpartof	concept:chemical:combustion
concept:coach:kentucky	concept:agentbelongstoorganization	concept:sportsteam:ncaa_youth_kids
concept:coach:locksley	concept:worksfor	concept:county:new_mexico
concept:sportsleague:western_conference	concept:agentcollaborateswithagent	concept:radiostation:san_antonio
concept:transportation:fax	concept:subpartof	concept:musicsong:form
concept:male:john_thompson_iii	concept:worksfor	concept:city:georgetown
concept:geopoliticallocation:agencies	concept:subpartoforganization	concept:governmentorganization:department
concept:newspaper:herald	concept:organizationheadquarteredincity	concept:county:los_angeles_county
concept:sportsteam:western_kentucky_hilltoppers	concept:agentcollaborateswithagent	concept:personmexico:ncaa
concept:city:uk	concept:organizationterminatedperson	concept:personasia:number
concept:city:worcester	concept:subpartof	concept:stateorprovince:massachusetts
concept:city:toronto	concept:organizationhiredperson	concept:coach:mitch_williams
concept:sportsteam:cleveland_state_vikings	concept:agentcollaborateswithagent	concept:personmexico:ncaa
concept:company:nbc	concept:agentcontrols	concept:televisionstation:kulr_tv
concept:city:washington_d_c	concept:organizationhiredperson	concept:celebrity:don_james
concept:county:penn_state	concept:subpartoforganization	concept:sportsteam:ncaa_youth_kids
concept:city:harrisonburg	concept:subpartof	concept:stateorprovince:virginia
concept:sportsteam:georgia_state	concept:organizationhiredperson	concept:personeurope:curry
concept:mlalgorithm:solutions	concept:subpartof	concept:visualizableattribute:drinking_water
concept:county:utah	concept:organizationhiredperson	concept:coach:kyle_whittingham
concept:coach:virginia_tech	concept:agentcontrols	concept:coach:frank_beamer
concept:city:father	concept:agentcollaborateswithagent	concept:company:clinton
concept:stateorprovince:california	concept:agentcontrols	concept:vehicle:services
concept:personmexico:ncaa	concept:agentcontrols	concept:sportsteam:notre_dame
concept:male:world	concept:agentcontrols	concept:city:number
concept:website:paypal	concept:subpartof	concept:retailstore:ebay
concept:company:apple002	concept:organizationheadquarteredincity	concept:city:cupertino
concept:vehicle:states	concept:subpartof	concept:vehicle:west_coast
concept:company:nbc	concept:agentcontrols	concept:televisionstation:wcnc_tv
concept:person:ronaldo	concept:worksfor	concept:politicsblog:star
concept:buildingfeature:systems	concept:subpartof	concept:beverage:advanced_water
concept:person:republican	concept:agentcollaborateswithagent	concept:politicianus:gov__sarah_palin
concept:televisionstation:wptz	concept:organizationheadquarteredincity	concept:city:burlington
concept:musicartist:journal	concept:agentcontrols	concept:company:los_angeles
concept:room:house	concept:subpartof	concept:hallwayitem:gas
concept:website:amazon	concept:organizationterminatedperson	concept:ceo:jeff_bezos
concept:personmexico:ncaa	concept:agentcontrols	concept:sportsteam:boston_college
concept:profession:newark	concept:subpartof	concept:bridge:new_jersey
concept:radiostation:cleveland	concept:organizationhiredperson	concept:coach:mangini
concept:museum:facilities	concept:subpartof	concept:beverage:municipal_water
concept:city:santa_rosa	concept:subpartof	concept:stateorprovince:california
concept:stateorprovince:minnesota	concept:organizationhiredperson	concept:coach:tim_brewster
concept:website:washington_times	concept:headquarteredin	concept:city:washington_d_c
concept:athlete:roy_williams	concept:worksfor	concept:creditunion:kansas
concept:bedroomitem:system	concept:subpartof	concept:musicalbum:stage
concept:personafrica:jonathan_schwartz	concept:worksfor	concept:company:sun
concept:company:nbc	concept:agentcontrols	concept:televisionstation:kmtr
concept:sportsteam:man_utd	concept:agentcollaborateswithagent	concept:person:ronaldo
concept:coach:louisville	concept:subpartof	concept:stateorprovince:colorado
concept:sportsteam:heat	concept:organizationhiredperson	concept:coach:van_gundy
concept:company:disney	concept:acquired	concept:company:abc_television_network
concept:mlalgorithm:solutions	concept:subpartof	concept:weatherphenomenon:air
concept:website:friendster	concept:companyeconomicsector	concept:economicsector:social_networking
concept:buildingfeature:systems	concept:subpartof	concept:beverage:modern_water
concept:politicalparty:democrats	concept:agentcollaborateswithagent	concept:politician:clinton
concept:sportsteam:pittsburg_state_gorillas	concept:subpartoforganization	concept:sportsteam:ncaa_youth_kids
concept:county:chicago	concept:subpartof	concept:stateorprovince:illinois
concept:city:xavier	concept:subpartoforganization	concept:sportsteam:ncaa_youth_kids
concept:automobilemaker:honda	concept:companyeconomicsector	concept:economicsector:auto
concept:county:los_angeles_county	concept:organizationhiredperson	concept:politicianus:richard_riordan
concept:female:yankees	concept:agentcollaborateswithagent	concept:personus:bernie_williams
concept:agent:division	concept:organizationterminatedperson	concept:scientist:no_
concept:person:duke	concept:agentcollaborateswithagent	concept:politicianus:mike_krzyzewski
concept:personmexico:ncaa	concept:subpartof	concept:sportsteam:ncaa_mens_midwest_regionals
concept:politician:obama	concept:agentcollaborateswithagent	concept:female:hillary
concept:televisionstation:wesh	concept:subpartoforganization	concept:televisionnetwork:nbc_universal
concept:biotechcompany:apple	concept:companyeconomicsector	concept:economicsector:consumer_electronics
concept:city:elyria	concept:subpartof	concept:university:ohio
concept:personmexico:ncaa	concept:agentcontrols	concept:sportsteam:liberty_flames
concept:sportsteam:o_s	concept:organizationhiredperson	concept:coach:doc_holliday
concept:newspaper:texas	concept:companyeconomicsector	concept:economicsector:insurance_companies
concept:geopoliticallocation:agencies	concept:subpartoforganization	concept:tradeunion:congress
concept:coach:new	concept:subpartof	concept:sportsgame:days_last_week
concept:personmexico:ncaa	concept:agentcontrols	concept:sportsteam:south_dakota_coyotes
concept:sportsteam:dallas_cowboys	concept:organizationhiredperson	concept:coach:wade_phillips
concept:terroristorganization:state	concept:agentcontrols	concept:physicalcharacteristic:statutes
concept:company:amazon_com_inc	concept:acquired	concept:company:abebooks
concept:city:cincinnati	concept:organizationhiredperson	concept:coach:mick_cronin
concept:blog:america_online	concept:agentcollaborateswithagent	concept:company:case
concept:televisionstation:wcmh_tv	concept:televisionstationaffiliatedwith	concept:televisionnetwork:nbc_universal
concept:newspaper:herald	concept:headquarteredin	concept:county:los_angeles_county
concept:governmentorganization:commission	concept:subpartof	concept:weatherphenomenon:water
concept:sportsteam:raptors	concept:organizationhiredperson	concept:coach:mitch_williams
concept:sportsteam:wake_forest_demon_deacons	concept:subpartoforganization	concept:sportsteam:ncaa_youth_kids
concept:stateorprovince:metairie	concept:subpartof	concept:musicsong:louisiana
concept:coach:new	concept:subpartof	concept:city:washington_d_c
concept:politicianus:jimmy_carter	concept:agentcollaborateswithagent	concept:politician:obama
concept:personus:denzel_washington	concept:agentcollaborateswithagent	concept:politician:obama
concept:sportsleague:new	concept:organizationhiredperson	concept:person:lane_kiffin
concept:personmexico:frank_robinson	concept:worksfor	concept:newspaper:wyoming
concept:personmexico:ryan_whitney	concept:worksfor	concept:governmentorganization:office
concept:personmexico:ryan_whitney	concept:worksfor	concept:governmentorganization:u_s__congress
concept:governmentorganization:doj	concept:organizationhiredperson	concept:personmexico:ryan_whitney
concept:room:house	concept:subpartof	concept:sportsteam:heat
concept:room:development	concept:subpartof	concept:weatherphenomenon:water
concept:journalist:tom_brokaw	concept:worksfor	concept:musicartist:television
concept:city:budget	concept:organizationhiredperson	concept:personmexico:ryan_whitney
concept:museum:facilities	concept:subpartof	concept:politicsissue:more_water
concept:person:mccain	concept:agentcollaborateswithagent	concept:politicianus:palin
concept:ceo:mark_zuckerberg	concept:topmemberoforganization	concept:website:facebook
concept:vehicle:states	concept:subpartof	concept:airport:south_america
concept:personcanada:search	concept:agentcontrols	concept:website:iphone
concept:coach:san_antonio_spurs	concept:subpartof	concept:sportsleague:nba
concept:athlete:paul_brown	concept:worksfor	concept:sportsteam:philadelphia_eagles
concept:county:york_city	concept:subpartof	concept:stateorprovince:new_york
concept:radiostation:job	concept:agentbelongstoorganization	concept:company:apple001
concept:musicartist:orange	concept:organizationhiredperson	concept:coach:greg_robinson
concept:visualartist:meyer	concept:subpartof	concept:buildingmaterial:head
concept:personmexico:ncaa	concept:agentcontrols	concept:sportsteam:jacksonville_state_gamecocks
concept:profession:employees	concept:subpartof	concept:weatherphenomenon:water
concept:city:boston	concept:organizationhiredperson	concept:politicianus:thomas_menino
concept:sportsteam:pittsburgh_panthers	concept:agentcollaborateswithagent	concept:personmexico:ncaa
concept:sportsteam:san_jose_sharks	concept:organizationhiredperson	concept:coach:al_arbour
concept:person:fred	concept:agentcollaborateswithagent	concept:male:world
concept:coach:alabama_crimson_tide	concept:subpartof	concept:sportsteam:ncaa_youth_kids
concept:city:service	concept:subpartoforganization	concept:governmentorganization:government
concept:bedroomitem:new	concept:subpartof	concept:bodypart:art
concept:sportsteam:denver_nuggets	concept:organizationhiredperson	concept:coach:george_karl
concept:county:seattle	concept:subpartof	concept:city:washington_d_c
concept:ceo:chad_hurley	concept:worksfor	concept:website:youtube
concept:governmentorganization:government	concept:agentcontrols	concept:emotion:data
concept:city:sheboygan	concept:subpartof	concept:creditunion:wisconsin
concept:university:parkersburg	concept:subpartof	concept:company:west_virginia
concept:sportsteam:blue_jays	concept:agentcontrols	concept:personmexico:roberto_alomar
concept:personmexico:ncaa	concept:agentcontrols	concept:sportsteam:weber_state_wildcats
concept:coach:indianapolis_colts	concept:subpartof	concept:sportsleague:nfl
concept:politicsissue:requirements	concept:subpartof	concept:visualizableattribute:drinking_water
concept:person:jose_juan_barea	concept:worksfor	concept:sportsteam:bucks
concept:county:temple_university	concept:organizationhiredperson	concept:professor:john_chaney
concept:writer:brown	concept:worksfor	concept:sportsteam:cavaliers
concept:televisionstation:kkco	concept:televisionstationaffiliatedwith	concept:televisionnetwork:nbc_universal
concept:politicianus:barack_obama	concept:agentcontrols	concept:hotel:white
concept:politicalparty:u_n_	concept:organizationhiredperson	concept:personmexico:ryan_whitney
concept:personmexico:ncaa	concept:agentcontrols	concept:sportsteam:texas_christian
concept:televisionstation:wise_tv	concept:subpartof	concept:retailstore:nbc
concept:personmexico:ncaa	concept:agentcontrols	concept:sportsteam:idaho_state_bengals
concept:company:nbc	concept:agentcontrols	concept:website:who_tv
concept:company:nbc	concept:agentcontrols	concept:televisionstation:wicd
concept:company:nbc	concept:agentcontrols	concept:televisionstation:kiem_tv
concept:sportsteam:kansas_state	concept:agentcollaborateswithagent	concept:personmexico:ncaa
concept:coach:mike_shula	concept:worksfor	concept:university:alabama
concept:personmexico:ncaa	concept:agentcontrols	concept:sportsteam:old_dominion_monarchs
concept:buildingfeature:systems	concept:subpartof	concept:chemical:condensate
concept:university:google	concept:organizationterminatedperson	concept:personasia:number
concept:museum:facilities	concept:subpartof	concept:visualizableattribute:rural_water
concept:county:florence	concept:subpartof	concept:university:kentucky
concept:televisionstation:kmtr	concept:subpartof	concept:retailstore:nbc
concept:sportsteam:tennessee_volunteers	concept:organizationhiredperson	concept:coach:philip_rivers
concept:weatherphenomenon:cape	concept:subpartof	concept:book:years
concept:coach:stephen_baker	concept:worksfor	concept:company:business_week
concept:politicianus:george_h__w__bush	concept:agentcontrols	concept:hotel:white
concept:coach:new	concept:subpartof	concept:politicsblog:more_times
concept:televisionstation:wbre_tv	concept:subpartoforganization	concept:televisionnetwork:nbc_universal
concept:televisionnetwork:cbs	concept:agentcollaborateswithagent	concept:person:edward_r__murrow
concept:company:intel	concept:agentcollaborateswithagent	concept:ceo:andy_grove
concept:programminglanguage:system	concept:subpartof	concept:visualizableattribute:storm_water
concept:person:republican	concept:agentcollaborateswithagent	concept:politicianus:dick_cheney
concept:buildingfeature:systems	concept:subpartof	concept:visualizablething:surface_water
concept:politicsissue:programs	concept:subpartof	concept:publication:ground_water
concept:personus:jeff_bezos	concept:worksfor	concept:governmentorganization:amazon_com
concept:coach:cincinnati	concept:subpartof	concept:university:ohio
concept:programminglanguage:system	concept:subpartof	concept:visualizablething:domestic_water
concept:county:orange_county	concept:subpartof	concept:stateorprovince:california
concept:company:nbc	concept:agentcontrols	concept:website:wkyc_tv
concept:city:tampa_bay	concept:organizationhiredperson	concept:coach:barry_melrose
concept:buildingfeature:systems	concept:subpartof	concept:visualizablething:drinking_water_supplies
concept:company:nbc	concept:agentcontrols	concept:televisionstation:ketk
concept:university:villanova	concept:subpartoforganization	concept:sportsteam:ncaa_youth_kids
concept:personmexico:ncaa	concept:agentcontrols	concept:sportsteam:new_mexico_lobos
concept:company:nbc	concept:agentcontrols	concept:televisionstation:wicu_tv
concept:coach:lou_holtz	concept:worksfor	concept:stateorprovince:south_carolina
concept:person:mccain	concept:agentcollaborateswithagent	concept:coach:sarah_palin
concept:biotechcompany:china	concept:organizationterminatedperson	concept:scientist:no_
concept:personmexico:ncaa	concept:agentcontrols	concept:sportsteam:idaho_vandals
concept:bank:viacom	concept:acquired	concept:company:paramount_pictures
concept:politicsblog:tribune	concept:agentcontrols	concept:museum:new_york_times
concept:city:oakland	concept:subpartof	concept:stateorprovince:california
concept:tradeunion:congress	concept:organizationhiredperson	concept:personus:party
concept:room:community	concept:subpartof	concept:room:space
concept:coach:louisville	concept:agentcontrols	concept:athlete:rick_pitino
concept:city:stamford	concept:subpartof	concept:stateorprovince:connecticut
concept:terroristorganization:state	concept:agentcontrols	concept:programminglanguage:services
concept:book:gateway	concept:subpartof	concept:plant:acer
concept:sportsteam:east_carolina_pirates	concept:subpartoforganization	concept:sportsteam:ncaa_youth_kids
concept:personmexico:ncaa	concept:agentcontrols	concept:sportsteam:wayne_state_warriors
concept:journalist:david_e__sanger	concept:worksfor	concept:musicartist:times
concept:male:notre_dame	concept:agentcollaborateswithagent	concept:coach:charlie_weis
concept:sportsteam:ncaa_youth_kids	concept:agentcontrols	concept:coach:minnesota_golden_gophers
concept:city:erie	concept:subpartof	concept:stateorprovince:pennsylvania
concept:sportsteam:illini	concept:organizationhiredperson	concept:coach:ron_zook
concept:sportsteam:northwestern_state_demons	concept:agentcollaborateswithagent	concept:personmexico:ncaa
concept:personmexico:ncaa	concept:agentcontrols	concept:sportsteam:texas_a_m_aggies
concept:animal:head	concept:agentcontrols	concept:person:anderson
concept:city:rockville	concept:subpartof	concept:stateorprovince:maryland
concept:stateorprovince:oklahoma	concept:organizationhiredperson	concept:coach:kelvin_sampson
concept:company:ibm	concept:acquired	concept:automobilemaker:lotus
concept:sportsteam:grambling_tigers	concept:agentcollaborateswithagent	concept:personmexico:ncaa
concept:sportsteam:packers	concept:organizationhiredperson	concept:athlete:mike_mccarthy
concept:visualizablescene:brussels	concept:subpartof	concept:country:belgium
concept:hallwayitem:point	concept:subpartof	concept:weatherphenomenon:water
concept:coach:baltimore_ravens	concept:agentbelongstoorganization	concept:sportsleague:nfl
concept:sportsteam:new_mexico_state_aggies	concept:agentcollaborateswithagent	concept:personmexico:ncaa
concept:sportsteam:pats	concept:organizationhiredperson	concept:person:belichick
concept:televisionstation:wpsd_tv	concept:subpartof	concept:retailstore:nbc
concept:company:expedia	concept:companyeconomicsector	concept:economicsector:travel
concept:bank:viacom	concept:acquired	concept:company:comedy_central
concept:sportsteam:alaska_fairbanks_nanooks	concept:subpartoforganization	concept:sportsteam:ncaa_youth_kids
concept:geopoliticallocation:option	concept:subpartof	concept:weatherphenomenon:water
concept:coach:kentucky_wildcats	concept:subpartof	concept:sportsteam:ncaa_youth_kids
concept:clothing:white	concept:subpartof	concept:street:congress
concept:mountain:fox	concept:agentcontrols	concept:website:wfld
concept:terroristorganization:money	concept:agentcollaborateswithagent	concept:terroristorganization:state
concept:geopoliticallocation:kerry	concept:agentcollaborateswithagent	concept:person:bill
concept:geopoliticallocation:agencies	concept:subpartoforganization	concept:governmentorganization:united_states_department
concept:musicartist:allies	concept:organizationhiredperson	concept:personus:party
concept:sportsteam:oral_roberts_golden_eagles	concept:subpartoforganization	concept:sportsteam:ncaa_youth_kids
concept:physicalaction:assembly	concept:subpartof	concept:weatherphenomenon:air
concept:sportsleague:new	concept:organizationhiredperson	concept:coach:scott_linehan
concept:sportsteam:memphis_grizzlies	concept:organizationhiredperson	concept:coach:marc_iavaroni
concept:magazine:fedex	concept:agentcollaborateswithagent	concept:athlete:fred_smith
concept:company:nbc	concept:agentcontrols	concept:televisionstation:wpbn
concept:sportsteam:southern_methodist_mustangs	concept:subpartoforganization	concept:sportsteam:ncaa_youth_kids
concept:sportsteamposition:application	concept:subpartof	concept:weatherphenomenon:air
concept:personmexico:ncaa	concept:agentcontrols	concept:sportsteam:vermont_catamounts
concept:programminglanguage:system	concept:subpartof	concept:visualizableattribute:drinking_water
concept:televisionstation:kusa_tv	concept:subpartof	concept:retailstore:nbc
concept:company:new_york	concept:agentcontrols	concept:website:jobs
concept:company:nbc	concept:companyeconomicsector	concept:academicfield:sports
concept:city:beverly_hills	concept:subpartof	concept:stateorprovince:california
concept:personmexico:ncaa	concept:agentcontrols	concept:sportsteam:akron_zips
concept:televisionshow:providence	concept:subpartof	concept:monument:rhode_island
concept:musicartist:journal	concept:agentcontrols	concept:mldataset:ny
concept:bedroomitem:system	concept:subpartof	concept:weapon:powerful_air
concept:personmexico:ncaa	concept:agentcontrols	concept:sportsteam:la_salle_explorers
concept:programminglanguage:services	concept:subpartof	concept:beverage:high_quality_water
concept:jobposition:facility	concept:subpartof	concept:weatherphenomenon:air
concept:city:georgetown	concept:organizationhiredperson	concept:coach:john_thompson
concept:programminglanguage:services	concept:subpartof	concept:beverage:industrial_water
concept:company:nbc	concept:agentcontrols	concept:televisionstation:kkco
concept:coach:new	concept:subpartof	concept:geopoliticallocation:dakota
concept:airport:minneapolis	concept:subpartof	concept:personnorthamerica:minnesota
concept:sportsteam:montreal_canadiens	concept:organizationhiredperson	concept:coach:guy_carbonneau
concept:televisionnetwork:cbs	concept:agentcontrols	concept:coach:douglas_edwards
concept:geopoliticallocation:kerry	concept:agentcollaborateswithagent	concept:personafrica:george_bush
concept:judge:mr_	concept:agentbelongstoorganization	concept:politicalparty:house
concept:sportsteam:redskins	concept:organizationhiredperson	concept:coach:jim_zorn
concept:politicianus:governor_sarah_palin	concept:agentcollaborateswithagent	concept:person:mccain
concept:tradeunion:congress	concept:organizationhiredperson	concept:journalist:the_white
concept:stateorprovince:oklahoma	concept:organizationhiredperson	concept:coach:bob_stoops
concept:blog:google	concept:acquired	concept:website:feedburner
concept:sportsteam:jacksonville_state_gamecocks	concept:agentcollaborateswithagent	concept:personmexico:ncaa
concept:city:novato	concept:subpartof	concept:stateorprovince:california
concept:company:nbc	concept:agentcontrols	concept:website:wsls_tv
concept:governmentorganization:government	concept:agentcontrols	concept:mediatype:white
concept:biotechcompany:white	concept:companyeconomicsector	concept:academicfield:law
concept:city:dallas	concept:organizationhiredperson	concept:politician:ray_hunt
concept:university:clemson	concept:organizationhiredperson	concept:coach:tommy_bowden
concept:vehicle:states	concept:subpartof	concept:city:florida
concept:stateorprovince:morning	concept:organizationhiredperson	concept:personmexico:ryan_whitney
concept:company:new_york	concept:organizationhiredperson	concept:person:rodriguez
concept:personus:paul_allen	concept:topmemberoforganization	concept:company:microsoft_corporation001
concept:geopoliticallocation:agencies	concept:subpartoforganization	concept:terroristorganization:state
concept:coach:new	concept:subpartof	concept:island:new_york_city_metropolitan_area
concept:personmexico:ncaa	concept:agentcontrols	concept:sportsteam:iowa_state
concept:programminglanguage:services	concept:subpartof	concept:visualizablething:commercial_water
concept:automobilemaker:gm	concept:companyeconomicsector	concept:economicsector:auto
concept:person:meg_whitman	concept:agentcontrols	concept:museum:steve
concept:company:ibm	concept:acquired	concept:company:ascential_software
concept:personmexico:ncaa	concept:agentcontrols	concept:sportsteam:rochester_yellow_jackets
concept:bedroomitem:new	concept:subpartof	concept:book:questions
concept:city:houston	concept:organizationhiredperson	concept:personaustralia:bill_white
concept:politician:jobs	concept:worksfor	concept:terroristorganization:point
concept:coach:new_jersey_nets	concept:agentbelongstoorganization	concept:sportsleague:nba
concept:mountain:fox	concept:agentcollaborateswithagent	concept:personus:john_gibson
concept:sportsteam:idaho_vandals	concept:agentcollaborateswithagent	concept:personmexico:ncaa
concept:website:tacoda	concept:organizationterminatedperson	concept:person:dave_morgan
concept:sportsteam:central_oklahoma_bronchos	concept:subpartoforganization	concept:sportsteam:ncaa_youth_kids
concept:personmexico:bernard_robinson	concept:worksfor	concept:sportsteam:knicks
concept:city:service	concept:subpartof	concept:city:texas
concept:televisionstation:wrcb_tv	concept:subpartoforganization	concept:televisionnetwork:nbc_universal
concept:hallwayitem:areas	concept:subpartof	concept:visualizableattribute:drinking_water
concept:university:purdue	concept:organizationhiredperson	concept:coach:gene_keady
concept:museum:facilities	concept:subpartof	concept:hobby:drinking
concept:county:philadelphia	concept:organizationhiredperson	concept:person:andy_reid
concept:sportsteam:oregon_state_beavers	concept:organizationhiredperson	concept:athlete:craig_robinson
concept:politicianus:ronald_reagan	concept:agentcollaborateswithagent	concept:city:bush
concept:city:duluth	concept:subpartof	concept:stateorprovince:minnesota
concept:county:miami	concept:agentbelongstoorganization	concept:sportsteam:ncaa_youth_kids
concept:university:stanford	concept:subpartoforganization	concept:sportsteam:ncaa_mens_midwest_regionals
concept:sportsleague:nfl	concept:agentcontrols	concept:coach:new_orleans_saints
concept:university:usc	concept:organizationhiredperson	concept:coach:tim_floyd
concept:sportsteam:minnesota_state_mavericks	concept:subpartoforganization	concept:sportsteam:ncaa_youth_kids
concept:city:casa_grande	concept:subpartof	concept:stateorprovince:arizona
concept:personmexico:ryan_whitney	concept:worksfor	concept:university:central_intelligence_agency
concept:biotechcompany:orange	concept:subpartoforganization	concept:university:france_telecom
concept:sportsleague:mlb	concept:agentcontrols	concept:athlete:boston_red_sox
concept:website:kvoa	concept:subpartof	concept:retailstore:nbc
concept:person:butler001	concept:agentcontrols	concept:personus:thomas_steen
concept:biotechcompany:apple	concept:headquarteredin	concept:city:cupertino
concept:coach:texas_tech	concept:agentbelongstoorganization	concept:sportsteam:ncaa_youth_kids
concept:city:forums	concept:subpartoforganization	concept:terroristorganization:state
concept:personmexico:ncaa	concept:agentcontrols	concept:sportsteam:florida_atlantic_owls
concept:politician:jobs	concept:agentcollaborateswithagent	concept:ceo:woz
concept:personmexico:ncaa	concept:agentcontrols	concept:sportsteam:georgetown_hoyas
concept:governmentorganization:treasury	concept:organizationhiredperson	concept:personmexico:ryan_whitney
concept:buildingfeature:systems	concept:subpartof	concept:visualizablething:home_air
concept:personmexico:ncaa	concept:agentcontrols	concept:sportsteam:unlv_runnin_rebels
concept:city:st__petersburg	concept:subpartof	concept:city:florida
concept:stateorprovince:oregon	concept:organizationhiredperson	concept:male:vin_lananna
concept:musicartist:journal	concept:agentcontrols	concept:personafrica:los_angeles_times
concept:governmentorganization:house	concept:agentcollaborateswithagent	concept:biotechcompany:white
concept:university:clemson	concept:organizationhiredperson	concept:coach:dabo_swinney
concept:person:mccain	concept:agentcollaborateswithagent	concept:politicianus:democratic_candidate_barack_obama
concept:company:word	concept:organizationhiredperson	concept:personmexico:ryan_whitney
concept:televisionstation:biloxi	concept:subpartof	concept:emotion:mississippi
concept:geometricshape:property	concept:subpartof	concept:weatherphenomenon:air
concept:televisionstation:wpsd_tv	concept:agentcollaborateswithagent	concept:company:nbc
concept:academicfield:businesses	concept:subpartof	concept:weatherphenomenon:air
concept:buildingfeature:systems	concept:subpartof	concept:chemical:air_conditioning
concept:company:rank	concept:companyeconomicsector	concept:economicsector:seo
concept:mountain:fox	concept:agentcontrols	concept:website:wupw
concept:personmexico:ncaa	concept:agentcontrols	concept:sportsteam:middle_tennessee_state_blue_raiders
concept:shoppingmall:palm_beach_gardens	concept:subpartof	concept:city:florida
concept:buildingfeature:systems	concept:subpartof	concept:visualizableattribute:scale_water
concept:city:home	concept:agentcontrols	concept:product:google
concept:male:world	concept:agentcontrols	concept:person:kevin
concept:personus:ken_lewis	concept:topmemberoforganization	concept:company:bofa
concept:creditunion:wisconsin	concept:subpartoforganization	concept:sportsteam:ncaa_youth_kids
concept:programminglanguage:system	concept:subpartof	concept:planet:fresh_water
concept:personmexico:ryan_whitney	concept:worksfor	concept:governmentorganization:agency
concept:musicartist:policy	concept:subpartoforganization	concept:professionalorganization:federal
concept:book:new	concept:subpartof	concept:politicsissue:meetings
concept:coach:bill_walsh	concept:worksfor	concept:city:dallas
concept:programminglanguage:system	concept:subpartof	concept:politicsissue:more_water
concept:website:influence	concept:organizationhiredperson	concept:personmexico:ryan_whitney
concept:sportsteam:wake_forest	concept:organizationhiredperson	concept:coach:jim_grobe
concept:stateorprovince:minnesota	concept:organizationhiredperson	concept:coach:dan_monson
concept:sportsteam:los_angeles_lakers	concept:organizationhiredperson	concept:coach:chris_quinn
concept:city:washington_d_c	concept:organizationhiredperson	concept:person:ty_willingham
concept:university:uf	concept:organizationhiredperson	concept:coach:urban_meyer
concept:county:utah	concept:organizationhiredperson	concept:coach:urban_meyer
concept:televisionstation:whec_tv	concept:subpartoforganization	concept:televisionnetwork:nbc_universal
concept:journalist:bob_herbert	concept:agentbelongstoorganization	concept:company:york_times
concept:city:area	concept:subpartof	concept:sport:clean_water
concept:buildingfeature:systems	concept:subpartof	concept:chemical:power_plants
concept:book:new	concept:subpartof	concept:website:market
concept:buildingfeature:systems	concept:subpartof	concept:chemical:floor
concept:personmexico:colorado_rockies	concept:agentbelongstoorganization	concept:sportsleague:mlb
concept:buildingfeature:systems	concept:subpartof	concept:beverage:well_water
concept:athlete:raymond_domenech	concept:worksfor	concept:sportsteam:france
concept:geopoliticallocation:ut	concept:organizationhiredperson	concept:coach:philip_fulmer
concept:coach:kansas_city_chiefs	concept:agentbelongstoorganization	concept:sportsleague:nfl
concept:sportsteam:indiana_state_sycamores	concept:agentcollaborateswithagent	concept:personmexico:ncaa
concept:date:n1977	concept:subpartof	concept:stateorprovince:california
concept:sportsteam:savannah_state_tigers	concept:agentcollaborateswithagent	concept:personmexico:ncaa
concept:university:reasons	concept:organizationhiredperson	concept:personmexico:ryan_whitney
concept:sportsteam:florida_international_golden_panthers	concept:subpartoforganization	concept:sportsteam:ncaa_youth_kids
concept:personmexico:ncaa	concept:agentcontrols	concept:sportsteam:maine_black_bears
concept:householditem:customer	concept:subpartof	concept:weatherphenomenon:water
concept:coach:louisville	concept:agentcontrols	concept:coach:steve_kragthorpe
concept:politicianus:governor_sarah_palin	concept:agentcollaborateswithagent	concept:person:republican
concept:company:flickr001	concept:companyeconomicsector	concept:economicsector:social_networking
concept:politicsblog:white_house	concept:organizationhiredperson	concept:personmexico:ryan_whitney
concept:blog:la_opini_n	concept:companyeconomicsector	concept:economicsector:insurance
concept:sportsteam:new_york_giants	concept:organizationhiredperson	concept:coach:spagnuolo
concept:company:oracle001	concept:acquired	concept:biotechcompany:bea_systems
concept:politicianus:candidate_barack_obama	concept:agentcollaborateswithagent	concept:person:mccain
concept:governmentorganization:government	concept:agentcontrols	concept:musicsong:loans
concept:politicianus:president_obama	concept:agentbelongstoorganization	concept:politicalparty:house
concept:person:john003	concept:worksfor	concept:website:new_york_times
concept:politicianus:jim	concept:agentcollaborateswithagent	concept:male:world
concept:tradeunion:agreement	concept:organizationhiredperson	concept:personmexico:ryan_whitney
concept:coach:new	concept:subpartof	concept:sportsgame:short_years
concept:sportsteam:alabama_birmingham_blazers	concept:subpartoforganization	concept:sportsteam:ncaa_youth_kids
concept:sportsleague:nfl	concept:agentcontrols	concept:coach:philadelphia_eagles
concept:city:army	concept:organizationterminatedperson	concept:person:moshe_ben_zikri
concept:chemical:management	concept:subpartof	concept:weatherphenomenon:land
concept:programminglanguage:services	concept:subpartof	concept:visualizableattribute:piped_water
concept:sportsteam:harvard_divinity_school	concept:organizationhiredperson	concept:coach:tim_murphy
concept:televisionstation:kalb_tv	concept:subpartof	concept:retailstore:nbc
concept:chemical:management	concept:subpartof	concept:chemical:groundwater
concept:sportsteam:southeast_missouri_state_redhawks	concept:subpartoforganization	concept:sportsteam:ncaa_youth_kids
concept:stateorprovince:ohio	concept:subpartof	concept:country:usa
concept:sportsteam:central_oklahoma_bronchos	concept:organizationhiredperson	concept:coach:bob_stoops
concept:stateorprovince:ardmore	concept:subpartof	concept:musicsong:oklahoma
concept:coach:new	concept:subpartof	concept:sportsgame:more_years
concept:personmexico:ncaa	concept:agentcontrols	concept:sportsteam:western_illinois
concept:city:madrid	concept:organizationhiredperson	concept:personmexico:juande_ramos
concept:city:joliet	concept:subpartof	concept:stateorprovince:illinois
concept:company:disney	concept:organizationheadquarteredincity	concept:city:burbank
concept:sportsteam:philadelphia_eagles	concept:organizationhiredperson	concept:person:andy_reid
concept:televisionstation:wtwc_tv	concept:subpartof	concept:retailstore:nbc
concept:televisionnetwork:cbs	concept:agentcontrols	concept:televisionstation:klas_tv
concept:buildingfeature:systems	concept:subpartof	concept:beverage:standard_air
concept:terroristorganization:state	concept:agentcontrols	concept:buildingfeature:systems
concept:coach:philip_fulmer	concept:subpartof	concept:televisionshow:football
concept:governmentorganization:iowa	concept:agentbelongstoorganization	concept:sportsteam:ncaa_youth_kids
concept:company:general_motors001	concept:acquired	concept:automobilemaker:opel
concept:sportsteam:pittsburgh_penguins	concept:organizationhiredperson	concept:coach:michel_therrien
concept:governmentorganization:government	concept:agentcollaborateswithagent	concept:athlete:records
concept:sportsteam:notre_dame	concept:agentcollaborateswithagent	concept:personmexico:ncaa
concept:televisionstation:wcnc_tv	concept:subpartof	concept:retailstore:nbc
concept:buildingfeature:home	concept:subpartof	concept:visualizableattribute:drinking_water
concept:politician:jobs	concept:agentcontrols	concept:transportation:two
concept:company:general_motors001	concept:acquired	concept:automobilemaker:daewoo
concept:personmexico:ryan_whitney	concept:worksfor	concept:organization:republicans
concept:vehicle:states	concept:subpartof	concept:country:soviet_union
concept:sportsteam:seahawks	concept:organizationhiredperson	concept:coach:mike_holmgren
concept:company:forbes001	concept:organizationterminatedperson	concept:ceo:steve_forbes
concept:company:new_york	concept:organizationhiredperson	concept:personmexico:isaiah_thomas
concept:company:nbc	concept:agentcontrols	concept:website:wdtn_tv
concept:sportsteam:army_black_knights	concept:agentcollaborateswithagent	concept:person:john_o_leary
concept:sportsteam:xavier_musketeers	concept:subpartoforganization	concept:sportsteam:ncaa_youth_kids
concept:programminglanguage:system	concept:subpartof	concept:sport:clean_water
concept:ceo:eric_schmidt	concept:agentcontrols	concept:product:google
concept:televisionstation:kalb_tv	concept:televisionstationaffiliatedwith	concept:televisionnetwork:nbc_universal
concept:country:italy	concept:agentcontrols	concept:personmexico:alberto_gilardino
concept:website:facebook	concept:companyeconomicsector	concept:economicsector:social_networking
concept:company:nbc	concept:agentcontrols	concept:televisionstation:wrcb_tv
concept:coach:bruce_weber	concept:worksfor	concept:sportsteam:illini
concept:sportsteam:toledo_rockets	concept:agentcollaborateswithagent	concept:personmexico:ncaa
concept:stateorprovince:rights	concept:subpartoforganization	concept:terroristorganization:state
concept:televisionstation:kmoh	concept:subpartof	concept:retailstore:nbc
concept:televisionstation:king_tv	concept:organizationheadquarteredincity	concept:city:seattle
concept:museum:facilities	concept:subpartof	concept:beverage:improved_water
concept:city:tampa_bay	concept:organizationhiredperson	concept:coach:jon_gruden
concept:buildingfeature:systems	concept:subpartof	concept:visualizableattribute:reliable_water
concept:musician:agencies	concept:subpartof	concept:musicartist:air
concept:coach:cincinnati	concept:agentbelongstoorganization	concept:sportsteam:ncaa_youth_kids
concept:newspaper:president_elect_barack_obama	concept:agentcollaborateswithagent	concept:person:mccain
concept:sportsteam:northern_illinois_huskies	concept:subpartoforganization	concept:sportsteam:ncaa_youth_kids
concept:radiostation:new_jersey	concept:companyeconomicsector	concept:economicsector:insurance_coverage
concept:sportsteam:bradley_braves	concept:agentcollaborateswithagent	concept:personmexico:ncaa
concept:company:nbc	concept:agentcontrols	concept:website:kyma
concept:buildingfeature:systems	concept:subpartof	concept:beverage:good_water
concept:personmexico:ryan_whitney	concept:worksfor	concept:governmentorganization:u_s__department
concept:politician:mark_l__mallory	concept:worksfor	concept:city:cincinnati
concept:sportsteam:pittsburg_state_gorillas	concept:agentcollaborateswithagent	concept:personmexico:ncaa
concept:sportsteam:buccaneers	concept:organizationhiredperson	concept:coach:john_gruden
concept:winery:hartford	concept:organizationhiredperson	concept:personeurope:eddie_perez
concept:company:nbc	concept:agentcontrols	concept:televisionstation:keci
concept:musicsong:galveston	concept:subpartof	concept:city:texas
concept:televisionstation:kark_tv	concept:subpartoforganization	concept:televisionnetwork:nbc_universal
concept:stateorprovince:indiana	concept:organizationterminatedperson	concept:coach:tom_crean
concept:city:forest	concept:subpartoforganization	concept:terroristorganization:state
concept:country:israel	concept:organizationhiredperson	concept:personmexico:ryan_whitney
concept:bedroomitem:system	concept:subpartof	concept:transportation:modern_air
concept:person:ter_petrosyan	concept:worksfor	concept:country:republic_of_armenia
concept:city:police	concept:organizationhiredperson	concept:personmexico:ryan_whitney
concept:city:service	concept:agentcontrols	concept:plant:apple
concept:buildingfeature:systems	concept:subpartof	concept:beverage:tap_water
concept:company:cnn	concept:organizationheadquarteredincity	concept:city:atlanta
concept:university:k_state	concept:organizationhiredperson	concept:person:snyder
concept:hospital:hialeah	concept:subpartof	concept:city:florida
concept:country:cuba	concept:agentbelongstoorganization	concept:sportsleague:mls
concept:geopoliticallocation:central_michigan	concept:organizationhiredperson	concept:coach:brian_kelly
concept:politicianus:palin	concept:agentcollaborateswithagent	concept:personus:party
concept:blog:goal	concept:organizationhiredperson	concept:athlete:john_o_shea
concept:athlete:ukraine	concept:subpartof	concept:vehicle:states
concept:governmentorganization:supreme_court	concept:organizationhiredperson	concept:personmexico:ryan_whitney
concept:female:hilary	concept:agentcollaborateswithagent	concept:person:house
concept:sportsteam:oilers	concept:subpartoforganization	concept:sportsleague:nhl
concept:sportsteam:boston_bruins	concept:organizationhiredperson	concept:person:tom_mcvie
concept:hobby:reading	concept:subpartof	concept:stateorprovince:pennsylvania
concept:website:universal	concept:subpartof	concept:company:vivendi
concept:buildingfeature:systems	concept:subpartof	concept:chemical:roads
concept:sportsteam:eastern_kentucky_colonels	concept:subpartoforganization	concept:sportsteam:ncaa_youth_kids
concept:company:west_virginia	concept:companyeconomicsector	concept:economicsector:insurance
concept:terroristorganization:state	concept:agentcontrols	concept:mlalgorithm:solutions
concept:journalist:maureen_dowd	concept:worksfor	concept:website:new_york_times
concept:sportsteam:unlv_runnin_rebels	concept:subpartoforganization	concept:sportsteam:ncaa_youth_kids
concept:female:yankees	concept:agentcollaborateswithagent	concept:personus:chien_ming_wang
concept:politician:jobs	concept:agentcontrols	concept:website:jobs
concept:city:resources	concept:subpartoforganization	concept:governmentorganization:federal_government
concept:city:newport_news_hampton_wmsburg	concept:subpartof	concept:stateorprovince:virginia
concept:website:new_york_times	concept:acquired	concept:blog:about_com
concept:male:world	concept:agentcontrols	concept:website:bill
concept:judge:mr_	concept:subpartof	concept:room:house
concept:buildingfeature:american	concept:subpartof	concept:city:york
concept:sportsteam:citadel_bulldogs	concept:agentcollaborateswithagent	concept:personmexico:ncaa
concept:city:princeton	concept:subpartof	concept:sportsteam:ncaa_youth_kids
concept:company:nbc	concept:agentcontrols	concept:website:kcbd_tv
concept:website:herald_tribune	concept:headquarteredin	concept:city:washington_d_c
concept:coach:tyrone_willingham	concept:worksfor	concept:city:washington_d_c
concept:company:yahoo001	concept:companyeconomicsector	concept:economicsector:internet
concept:university:oracle	concept:organizationhiredperson	concept:person:ray_lane
concept:governmentorganization:department	concept:subpartof	concept:weatherphenomenon:water
concept:company:nbc	concept:agentcontrols	concept:website:wwlp
concept:professor:david_pogue	concept:worksfor	concept:musicartist:times
concept:stateorprovince:iowa_hawkeyes	concept:subpartoforganization	concept:sportsteam:ncaa_youth_kids
concept:stateorprovince:hawaii	concept:organizationhiredperson	concept:coach:greg_mcmackin
concept:company:microsoft_corporation001	concept:headquarteredin	concept:city:redmond
concept:city:novi	concept:subpartof	concept:stateorprovince:michigan
concept:university:cu	concept:organizationhiredperson	concept:coach:dan_hawkins
concept:sportsleague:western_conference	concept:agentcontrols	concept:sportsteam:los_angeles_lakers
concept:company:dow_jones	concept:acquired	concept:biotechcompany:marketwatch
concept:sportsteam:sd_chargers	concept:organizationhiredperson	concept:coach:norv_turner
concept:sportsteam:heat	concept:organizationhiredperson	concept:person:pat_riley
concept:city:home	concept:agentcollaborateswithagent	concept:stateorprovince:contact
concept:company:fox	concept:companyeconomicsector	concept:academicfield:sports
concept:sportsleague:mlb	concept:agentcontrols	concept:sportsteam:rangers
concept:politicsblog:wis	concept:agentcollaborateswithagent	concept:company:nbc
concept:scientist:andres_oppenheimer	concept:worksfor	concept:newspaper:herald
concept:coach:new	concept:subpartof	concept:airport:europe
concept:animal:head	concept:agentcontrols	concept:personaustralia:smith
concept:sportsteam:uc_davis_aggies	concept:subpartoforganization	concept:sportsteam:ncaa_youth_kids
concept:sportsleague:nfl	concept:organizationhiredperson	concept:coach:dungy
concept:magazine:picture	concept:organizationhiredperson	concept:personmexico:ryan_whitney
concept:county:indiana_university	concept:organizationhiredperson	concept:coach:bob_knight
concept:personmexico:ncaa	concept:agentcontrols	concept:sportsteam:vanderbilt_commodores
concept:geopoliticalorganization:new_england	concept:organizationhiredperson	concept:person:belichick
concept:personmexico:ncaa	concept:agentcontrols	concept:sportsteam:richmond_spiders
concept:buildingfeature:home	concept:subpartof	concept:beverage:good_water
concept:visualizablescene:joplin	concept:subpartof	concept:company:missouri
concept:politicianus:senator_obama	concept:agentcollaborateswithagent	concept:person:mccain
concept:sportsteam:loyola_marymount_lions	concept:subpartoforganization	concept:sportsteam:ncaa_youth_kids
concept:sportsteam:iowa_state	concept:subpartoforganization	concept:sportsteam:ncaa_mens_midwest_regionals
concept:journalist:jon_decker	concept:worksfor	concept:company:reuters
concept:athlete:lidstrom	concept:worksfor	concept:sportsteam:red_wings
concept:stateorprovince:illinois	concept:organizationhiredperson	concept:coach:ron_zook
concept:sportsteam:northern_iowa_panthers	concept:subpartoforganization	concept:sportsteam:ncaa_youth_kids
concept:coach:new_jersey_nets	concept:subpartof	concept:sportsleague:nba
concept:politicianus:stephen_goldsmith	concept:worksfor	concept:televisionstation:indianapolis
concept:company:flickr001	concept:subpartoforganization	concept:university:yahoo
concept:plant:acer	concept:subpartof	concept:book:gateway
concept:coach:tony_dungy	concept:worksfor	concept:sportsteam:buccaneers
concept:person:tom_friedman	concept:worksfor	concept:musicartist:times
concept:company:apple	concept:organizationterminatedperson	concept:politician:jobs
concept:coach:new	concept:subpartof	concept:city:communities
concept:sportsteam:ohio_state_university	concept:organizationhiredperson	concept:coach:tressel
concept:politician:jobs	concept:worksfor	concept:university:yahoo
concept:creditunion:michigan	concept:subpartoforganization	concept:sportsteam:ncaa_youth_kids
concept:country:iran	concept:organizationhiredperson	concept:personmexico:ryan_whitney
concept:bedroomitem:new	concept:subpartof	concept:room:dates
concept:writer:brian_billick	concept:worksfor	concept:county:baltimore
concept:sportsteam:georgia_bulldogs	concept:agentcollaborateswithagent	concept:personmexico:ncaa
concept:biotechcompany:apple	concept:agentcollaborateswithagent	concept:radiostation:job
concept:sportsteam:new_orleans_saints	concept:organizationhiredperson	concept:coach:byron_scott
concept:university:depaul	concept:subpartoforganization	concept:sportsteam:ncaa_youth_kids
concept:company:nashua	concept:subpartof	concept:politicsblog:new_hampshire
concept:personmexico:ncaa	concept:agentcontrols	concept:university:arkansas_little_rock_trojans
concept:sportsteam:ohio_bobcats	concept:subpartoforganization	concept:sportsteam:ncaa_youth_kids
concept:politician:jobs	concept:worksfor	concept:county:newton
concept:perceptionaction:council_bluffs	concept:subpartof	concept:musicalbum:iowa
concept:male:sun	concept:agentcollaborateswithagent	concept:personafrica:jonathan_schwartz
concept:sportsteam:redskins	concept:organizationhiredperson	concept:coach:george_halas
concept:newspaper:krnv_tv	concept:subpartof	concept:retailstore:nbc
concept:governmentorganization:government	concept:agentcontrols	concept:politicsissue:more_money
concept:filmfestival:croatia	concept:subpartof	concept:vehicle:countries
concept:website:amazon	concept:agentcontrols	concept:automobilemaker:jeff_bezos
concept:publication:espn	concept:companyeconomicsector	concept:academicfield:sports
concept:coach:washington_huskies	concept:subpartof	concept:sportsteam:ncaa_youth_kids
concept:sportsteam:georgia_state	concept:subpartoforganization	concept:sportsteam:ncaa_mens_midwest_regionals
concept:female:yankees	concept:agentcollaborateswithagent	concept:personus:johnny_damon
concept:automobilemaker:toyota	concept:companyeconomicsector	concept:economicsector:automobile
concept:personmexico:ncaa	concept:agentcontrols	concept:sportsteam:stephen_f_austin_lumberjacks
concept:company:clinton	concept:agentcollaborateswithagent	concept:personus:party
concept:city:st_louis	concept:organizationhiredperson	concept:coach:steve_spagnuolo
concept:city:arena	concept:subpartof	concept:weatherphenomenon:water
concept:city:denver	concept:organizationhiredperson	concept:coach:shanahan
concept:city:service	concept:subpartof	concept:biotechcompany:apple
concept:biotechcompany:salt_lake_city	concept:subpartof	concept:county:utah
concept:company:abebooks	concept:companyeconomicsector	concept:economicsector:internet
concept:sportsleague:new	concept:organizationhiredperson	concept:person:rodriguez
concept:sportsteamposition:coordinator	concept:subpartof	concept:weatherphenomenon:water
concept:governmentorganization:government	concept:agentcontrols	concept:transportation:money
concept:website:wdtn	concept:subpartof	concept:retailstore:nbc
concept:website:orange	concept:subpartof	concept:company:france_telecom
concept:chemical:pipes	concept:subpartof	concept:planet:water_pipes
concept:newspaper:tribune	concept:agentcontrols	concept:website:new_york_times_a
concept:personmexico:ncaa	concept:agentcontrols	concept:sportsteam:butler_bulldogs
concept:person:ronaldo	concept:worksfor	concept:sportsteam:man_utd
concept:website:wsmv	concept:subpartof	concept:retailstore:nbc
concept:coach:new_orleans_saints	concept:subpartof	concept:sportsleague:nfl
concept:city:texas	concept:organizationhiredperson	concept:coach:darrell_royal
concept:personmexico:ncaa	concept:agentcontrols	concept:sportsteam:smu_mustangs
concept:website:submit	concept:subpartoforganization	concept:blog:form
concept:company:cnn	concept:headquarteredin	concept:city:atlanta
concept:company:nbc	concept:agentcontrols	concept:televisionstation:wstm
concept:room:homes	concept:subpartof	concept:weatherphenomenon:air
concept:person:toomas_hendrik_ilves	concept:worksfor	concept:country:estonia
concept:politicianus:harry_reid	concept:agentcollaborateswithagent	concept:politician:obama
concept:city:marietta	concept:subpartof	concept:stateorprovince:georgia
concept:sportsteam:stanford	concept:subpartoforganization	concept:sportsteam:ncaa_youth_kids
concept:politician:jobs	concept:worksfor	concept:automobilemaker:jeff_bezos
concept:politician:jobs	concept:agentcollaborateswithagent	concept:personus:jobs
concept:planet:crisis	concept:subpartof	concept:weatherphenomenon:water
concept:politicianus:bill_clinton	concept:agentcontrols	concept:hotel:white
concept:personmexico:ncaa	concept:agentcontrols	concept:sportsteam:houston_cougars
concept:person:mccain	concept:agentcollaborateswithagent	concept:politicianus:gov__sarah_palin
concept:person:bill	concept:worksfor	concept:university:microsoft
concept:geopoliticallocation:agencies	concept:subpartoforganization	concept:stateorprovince:california
concept:televisionstation:knsd	concept:subpartof	concept:retailstore:nbc
concept:company:nbc	concept:agentcontrols	concept:website:kxas_tv
concept:male:world	concept:agentcollaborateswithagent	concept:politicianus:jim
concept:terroristorganization:state	concept:agentcontrols	concept:programminglanguage:procedures
concept:coach:new_york_jets	concept:agentbelongstoorganization	concept:sportsleague:nfl
concept:recordlabel:universal	concept:subpartoforganization	concept:company:vivendi_games
concept:governmentorganization:intelligence_community	concept:organizationhiredperson	concept:personmexico:ryan_whitney
concept:sportsteam:charleston_cougars	concept:subpartoforganization	concept:sportsteam:ncaa_youth_kids
concept:personmexico:ncaa	concept:agentcontrols	concept:sportsteam:colorado_college
concept:politician:jobs	concept:agentcollaborateswithagent	concept:city:team
concept:sportsteam:appalachian_state_mo	concept:subpartoforganization	concept:sportsteam:ncaa_youth_kids
concept:country:united_states	concept:organizationterminatedperson	concept:personasia:number
concept:company:daily_news001	concept:headquarteredin	concept:county:los_angeles_county
concept:buildingfeature:systems	concept:subpartof	concept:visualizableattribute:drinking_water
concept:sportsteamposition:application	concept:subpartof	concept:weatherphenomenon:water
concept:governmentorganization:government	concept:agentcontrols	concept:weapon:properties
concept:terroristorganization:state	concept:agentcontrols	concept:televisionshow:bodies
concept:country:__america	concept:agentcontrols	concept:city:number
concept:company:kget001	concept:organizationheadquarteredincity	concept:city:bakersfield
concept:person:edwards	concept:agentcollaborateswithagent	concept:person:bill
concept:personmexico:ncaa	concept:agentcontrols	concept:sportsteam:east_tennessee_state_buccaneers
concept:sportsteam:lsu	concept:agentcontrols	concept:coach:saban
concept:coach:bill_curry	concept:worksfor	concept:university:kentucky
concept:sportsteam:eastern_illinois_panthers	concept:subpartoforganization	concept:sportsteam:ncaa_youth_kids
concept:ceo:eric_schmidt	concept:topmemberoforganization	concept:blog:google
concept:company:ibm	concept:companyeconomicsector	concept:economicsector:computer
concept:sportsteam:florida_gulf_coast_eagles	concept:subpartoforganization	concept:sportsteam:ncaa_youth_kids
concept:website:youtube_last_year	concept:organizationterminatedperson	concept:ceo:chad_hurley
concept:radiostation:cleveland	concept:organizationhiredperson	concept:politicianus:carl_b__stokes
concept:person:mccain	concept:agentcollaborateswithagent	concept:politicianus:barack_obama
concept:programminglanguage:services	concept:subpartof	concept:beverage:municipal_water
concept:company:bofa	concept:organizationterminatedperson	concept:personus:ken_lewis
concept:coach:cincinnati	concept:subpartof	concept:sportsteam:ncaa_youth_kids
concept:sportsteam:alabama_crimson_tide	concept:subpartoforganization	concept:sportsteam:ncaa_youth_kids
concept:sportsteam:western_michigan_broncos	concept:subpartoforganization	concept:sportsteam:ncaa_youth_kids
concept:company:microsoft	concept:acquired	concept:company:connectix
concept:county:brooklyn	concept:subpartof	concept:company:new_york
concept:sportsteam:chowan_braves	concept:agentcollaborateswithagent	concept:personus:andruw_jones
concept:university:stanford	concept:subpartoforganization	concept:sportsteam:ncaa_youth_kids
concept:city:decatur	concept:subpartof	concept:stateorprovince:georgia
concept:magazine:orlando	concept:organizationhiredperson	concept:coach:van_gundy
concept:governmentorganization:representatives	concept:organizationhiredperson	concept:personmexico:ryan_whitney
concept:company:nbc	concept:agentcontrols	concept:televisionstation:wwbt_tv
concept:museum:facilities	concept:subpartof	concept:crustacean:toilet
concept:sportsteam:texas_a_m	concept:organizationhiredperson	concept:personmexico:billy_gillispie
concept:coach:mitch_williams	concept:worksfor	concept:sportsteam:raptors
concept:programminglanguage:the_new	concept:subpartof	concept:bodypart:art
concept:website:kcbd_tv	concept:subpartof	concept:retailstore:nbc
concept:personmexico:antonio_villaraigosa	concept:worksfor	concept:company:los_angeles
concept:personmexico:ryan_whitney	concept:worksfor	concept:tradeunion:congress
concept:mlalgorithm:solutions	concept:subpartof	concept:visualizablething:water_supply
concept:publication:people_	concept:subpartof	concept:weatherphenomenon:air
concept:chemical:management	concept:subpartof	concept:weatherphenomenon:water
concept:governmentorganization:fema	concept:organizationhiredperson	concept:personmexico:ryan_whitney
concept:musicalbum:jackson	concept:subpartof	concept:sportsteam:chicago_bulls
concept:musicalbum:seasons	concept:subpartof	concept:traditionalgame:vegas
concept:personmexico:ncaa	concept:agentcontrols	concept:sportsteam:vcu_rams
concept:personmexico:ncaa	concept:agentcontrols	concept:sportsteam:charlotte_49ers
concept:sportsteam:samford_bulldogs	concept:subpartoforganization	concept:sportsteam:ncaa_youth_kids
concept:county:sacramento	concept:subpartof	concept:stateorprovince:california
concept:sportsteam:louisville_cardinals	concept:subpartoforganization	concept:sportsteam:ncaa_youth_kids
concept:politicianus:mr__bush	concept:agentbelongstoorganization	concept:politicalparty:house
concept:politician:jobs	concept:agentcontrols	concept:politicsissue:creation
concept:stateorprovince:indiana	concept:organizationterminatedperson	concept:coach:terry_hoeppner
concept:politician:sam_sullivan	concept:worksfor	concept:city:vancouver
concept:person:macintosh	concept:agentcollaborateswithagent	concept:politician:jobs
concept:radiostation:grand_rapids	concept:subpartof	concept:creditunion:michigan
concept:hotel:white	concept:subpartof	concept:governmentorganization:department
concept:televisionstation:ksnw	concept:subpartof	concept:retailstore:nbc
concept:city:longmont	concept:subpartof	concept:stateorprovince:colorado
concept:sportsteam:syracuse_orangemen	concept:agentcollaborateswithagent	concept:personmexico:ncaa
concept:person:john003	concept:worksfor	concept:stateorprovince:times
concept:county:detroit	concept:subpartof	concept:geopoliticallocation:wayne
concept:company:postini	concept:subpartoforganization	concept:university:google
concept:bedroomitem:rate	concept:subpartof	concept:weatherphenomenon:water
concept:politicianus:nancy_pelosi	concept:agentcollaborateswithagent	concept:politician:obama
concept:county:tallahassee	concept:agentcollaborateswithagent	concept:politicianus:john_marks
concept:sportsteam:flyers_playoff_tickets	concept:subpartoforganization	concept:sportsleague:nfl
concept:sportsteam:kansas_city_chiefs	concept:organizationhiredperson	concept:coach:herm_edwards
concept:personmexico:ryan_whitney	concept:worksfor	concept:city:team
concept:company:ibm	concept:acquired	concept:company:informix
concept:person:miley_cyrus	concept:agentcollaborateswithagent	concept:politician:obama
concept:vehicle:states	concept:subpartof	concept:programminglanguage:state
concept:celebrity:davidson_wildcats	concept:subpartof	concept:sportsteam:ncaa_youth_kids
concept:professionalorganization:lions	concept:organizationhiredperson	concept:politician:schwartz
concept:person:michael002	concept:agentcollaborateswithagent	concept:male:world
concept:company:twitter	concept:organizationterminatedperson	concept:ceo:jack_dorsey
concept:sportsteam:new_england_patriots	concept:organizationhiredperson	concept:coach:bill_parcells
concept:museum:facilities	concept:subpartof	concept:sport:clean_water
concept:sportsteam:golden_state_warriors	concept:organizationhiredperson	concept:coach:don_nelson
concept:politicalparty:college	concept:organizationhiredperson	concept:writer:knight
concept:company:cendant	concept:acquired	concept:company:orbitz_worldwide
concept:city:york	concept:subpartof	concept:river:state
concept:politician:obama	concept:agentcollaborateswithagent	concept:personus:denzel_washington
concept:terroristorganization:state	concept:agentcollaborateswithagent	concept:terroristorganization:money
concept:company:canada	concept:companyeconomicsector	concept:economicsector:life_insurance
concept:sportsteam:jacksonville_state_gamecocks	concept:subpartoforganization	concept:sportsteam:ncaa_youth_kids
concept:stateorprovince:illinois	concept:subpartof	concept:country:usa
concept:company:imac	concept:agentcollaborateswithagent	concept:politician:jobs
concept:male:world	concept:agentcollaborateswithagent	concept:newspaper:jane
concept:musician:agencies	concept:agentbelongstoorganization	concept:governmentorganization:united_states_department
concept:company:apple002	concept:headquarteredin	concept:city:london_city
concept:mountain:fox	concept:agentcontrols	concept:website:ksaz_tv
concept:company:nbc	concept:agentcontrols	concept:newspaper:krnv_tv
concept:televisionstation:associated_press	concept:organizationheadquarteredincity	concept:county:los_angeles_county
concept:politician:jobs	concept:agentcontrols	concept:website:amazon
concept:sportsteam:longwood_lancers	concept:subpartoforganization	concept:sportsteam:ncaa_youth_kids
concept:company:press	concept:headquarteredin	concept:city:washington_d_c
concept:male:barak	concept:agentcollaborateswithagent	concept:company:clinton
concept:politicianus:president_george_w__bush	concept:agentbelongstoorganization	concept:politicalparty:house
concept:televisionstation:wpsd_tv	concept:televisionstationaffiliatedwith	concept:televisionnetwork:nbc_universal
concept:sportsteam:notre_dame	concept:organizationhiredperson	concept:coach:dan_devine
concept:televisionstation:kwqc_tv	concept:subpartof	concept:retailstore:nbc
concept:university:butler	concept:subpartoforganization	concept:sportsteam:ncaa_mens_midwest_regionals
concept:personmexico:ryan_whitney	concept:worksfor	concept:governmentorganization:capitol
concept:university:newsweek	concept:organizationhiredperson	concept:personmexico:ryan_whitney
concept:company:nbc	concept:agentcontrols	concept:televisionstation:wpxi_tv
concept:nongovorganization:gop	concept:agentcontrols	concept:sociopolitical:palin
concept:personmexico:ncaa	concept:agentcontrols	concept:sportsteam:wisconsin_milwaukee_panthers
concept:transportation:network	concept:subpartof	concept:visualizablething:water_supply
concept:personmexico:ncaa	concept:agentcontrols	concept:sportsteam:cal_state_northridge_matadors
concept:programminglanguage:procedures	concept:subpartof	concept:weatherphenomenon:water
concept:city:san_rafael	concept:subpartof	concept:stateorprovince:california
concept:sportsteam:richmond_spiders	concept:agentcollaborateswithagent	concept:personmexico:ncaa
concept:company:arizona	concept:companyeconomicsector	concept:economicsector:insurance
concept:city:pittsburgh	concept:agentcollaborateswithagent	concept:person:nate_mclouth
concept:sportsteam:suns	concept:organizationhiredperson	concept:coach:terry_porter
concept:hallwayitem:market	concept:subpartof	concept:weatherphenomenon:water
concept:coach:mike_martz	concept:worksfor	concept:sportsteam:rams
concept:sportsteam:vols	concept:organizationhiredperson	concept:coach:philip_fulmer
concept:musicartist:season	concept:organizationhiredperson	concept:personcanada:ken_whisenhunt
concept:personmexico:ncaa	concept:agentcontrols	concept:sportsteam:austin_peay_governors
concept:university:alabama	concept:organizationhiredperson	concept:coach:saban
concept:personmexico:ncaa	concept:agentcontrols	concept:sportsteam:bowling_green_falcons
concept:journalist:ann_curry	concept:worksfor	concept:blog:today
concept:musicartist:journal	concept:agentcontrols	concept:personcanada:usa_today
concept:bedroomitem:new	concept:subpartof	concept:musicalbum:decades
concept:athlete:herman_edwards	concept:worksfor	concept:sportsteam:kansas_city_chiefs
concept:newspaper:philadelphia_inquirer	concept:organizationterminatedperson	concept:person:brian_tierney
concept:city:palo_alto	concept:subpartof	concept:stateorprovince:california
concept:sportsteam:brazil	concept:organizationhiredperson	concept:coach:dunga
concept:musicartist:journal	concept:agentcontrols	concept:university:newsweek
concept:city:brooklyn	concept:subpartof	concept:county:york_city
concept:personmexico:ncaa	concept:agentcontrols	concept:sportsteam:tennessee_volunteers
concept:sportsteam:blue_jays	concept:agentcontrols	concept:personus:fred_mcgriff
concept:person:edward_r__murrow	concept:worksfor	concept:televisionnetwork:cbs
concept:sportsleague:western_conference	concept:agentcollaborateswithagent	concept:sportsteam:suns
concept:buildingfeature:systems	concept:subpartof	concept:visualizablething:domestic_water
concept:buildingfeature:systems	concept:subpartof	concept:beverage:safe_water
concept:coach:new	concept:subpartof	concept:city:boston
concept:city:rio	concept:subpartof	concept:sportsteam:brazil
concept:personus:roger_smith	concept:topmemberoforganization	concept:company:general_motors
concept:university:google	concept:organizationhiredperson	concept:person:home001
concept:sportsteam:jacksonville_jaguars	concept:organizationhiredperson	concept:coach:jack_del_rio
concept:sportsteam:louisiana_lafayette_ragin_cajuns	concept:agentcollaborateswithagent	concept:personmexico:ncaa
concept:company:services	concept:subpartoforganization	concept:terroristorganization:state
concept:company:microsoft_corporation	concept:acquired	concept:company:tellme
concept:university:loyola	concept:organizationhiredperson	concept:coach:jimmy_patsos
concept:person:larry_ellison	concept:topmemberoforganization	concept:company:oracle
concept:programminglanguage:system	concept:subpartof	concept:hallwayitem:fuel
concept:university:france_telecom	concept:subpartof	concept:website:orange
concept:stateorprovince:illinois	concept:organizationhiredperson	concept:coach:bruce_weber
concept:personmexico:ncaa	concept:agentcontrols	concept:sportsteam:missouri_western_state_griffons
concept:governmentorganization:department	concept:organizationhiredperson	concept:coach:clinton_white
concept:musicartist:journal	concept:agentcontrols	concept:mountain:fox
concept:county:records	concept:agentcontrols	concept:clothing:white
concept:governmentorganization:iowa	concept:organizationhiredperson	concept:coach:dan_gable
concept:sportsleague:nfl	concept:organizationhiredperson	concept:coach:bill_walsh
concept:terroristorganization:state	concept:agentcontrols	concept:programminglanguage:body
concept:transportation:stations	concept:subpartof	concept:weatherphenomenon:air
concept:company:dow_jones	concept:acquired	concept:newspaper:wall_street_journal
concept:blog:wood_tv	concept:subpartof	concept:retailstore:nbc
concept:politicaloffice:office	concept:subpartof	concept:musicalbum:air
concept:company:post	concept:headquarteredin	concept:county:los_angeles_county
concept:river:klamath	concept:subpartof	concept:politicsissue:oregon
concept:politicianus:dick_cheney	concept:agentcollaborateswithagent	concept:person:republican
concept:academicfield:certification	concept:subpartof	concept:weatherphenomenon:water
concept:geopoliticallocation:kerry	concept:agentcollaborateswithagent	concept:company:clinton
concept:coach:guus_hiddink	concept:worksfor	concept:country:russia
concept:sportsteam:oregon_ducks	concept:agentcollaborateswithagent	concept:personmexico:ncaa
concept:politician:jobs	concept:worksfor	concept:geopoliticallocation:world
concept:visualizablething:scottsdale	concept:subpartof	concept:beverage:arizona
concept:university:kentucky	concept:organizationhiredperson	concept:coach:billy_gillespie
concept:shoppingmall:pompano_beach	concept:subpartof	concept:city:florida
concept:personmexico:ncaa	concept:agentcontrols	concept:sportsteam:eastern_kentucky_colonels
concept:museum:facilities	concept:subpartof	concept:bathroomitem:water_treatment
concept:personaustralia:tubby_smith	concept:worksfor	concept:university:kentucky
concept:sportsteam:virginia_tech_hokies	concept:agentcollaborateswithagent	concept:personmexico:ncaa
concept:stateorprovince:ole_miss	concept:organizationhiredperson	concept:coach:ed_orgeron
concept:automobilemaker:saab	concept:organizationheadquarteredincity	concept:city:pittsburgh
concept:sportsteam:penn_state_nittany_lions	concept:agentcollaborateswithagent	concept:personmexico:ncaa
concept:journalist:thomas_friedman	concept:worksfor	concept:website:new_york_times
concept:book:amsterdam	concept:subpartof	concept:agent:netherlands
concept:company:arizona	concept:subpartoforganization	concept:sportsteam:ncaa_youth_kids
concept:female:yankees	concept:agentcollaborateswithagent	concept:celebrity:ian_kennedy
concept:sportsteam:usc	concept:organizationhiredperson	concept:coach:carroll
concept:televisionstation:weau_tv	concept:subpartof	concept:retailstore:nbc
concept:politician:jobs	concept:agentcontrols	concept:product:apple_tv
concept:company:disney	concept:organizationhiredperson	concept:ceo:jeffrey_katzenberg
concept:sportsteam:auburn_university	concept:organizationhiredperson	concept:coach:tommy_tuberville
concept:company:amazon_com_inc	concept:organizationterminatedperson	concept:personus:jeff_bezos
concept:vehicle:services	concept:subpartof	concept:visualizableattribute:cost_effective_water
concept:county:columbus	concept:subpartof	concept:emotion:mississippi
concept:sportsteam:l_a__kings	concept:subpartoforganization	concept:sportsleague:nba
concept:person:duke	concept:agentcontrols	concept:coach:ted_roof
concept:company:disney	concept:headquarteredin	concept:city:burbank
concept:county:baltimore	concept:organizationhiredperson	concept:politician:sheila_dixon
concept:buildingfeature:systems	concept:subpartof	concept:buildingmaterial:drainage
concept:personmexico:ncaa	concept:agentcontrols	concept:sportsteam:mississippi_valley_state_delta_devils
concept:politician:jobs	concept:subpartof	concept:retailstore:apple_computer_inc_
concept:televisionstation:wvla	concept:subpartof	concept:retailstore:nbc
concept:automobilemaker:ford	concept:companyeconomicsector	concept:economicsector:automobile
concept:athlete:rockies	concept:agentcollaborateswithagent	concept:personus:clint_barmes
concept:buildingfeature:project	concept:subpartof	concept:visualizableattribute:major_water
concept:politician:jobs	concept:agentcontrols	concept:person:meg_whitman
concept:company:nbc	concept:agentcontrols	concept:televisionstation:ktve_tv
concept:politicsblog:wall_street_journal	concept:subpartoforganization	concept:company:dow_jones
concept:newspaper:idaho	concept:companyeconomicsector	concept:economicsector:insurance
concept:coach:rex_ryan	concept:worksfor	concept:sportsteam:new_york_jets
concept:company:nbc	concept:agentcontrols	concept:televisionstation:wgbc
concept:city:centre	concept:agentcollaborateswithagent	concept:person:state
concept:company:clinton	concept:agentcollaborateswithagent	concept:geopoliticallocation:kerry
concept:personus:ken_lewis	concept:agentcontrols	concept:book:america
concept:politicianus:senator_clinton	concept:agentcollaborateswithagent	concept:person:mccain
concept:geopoliticalorganization:grant	concept:subpartoforganization	concept:terroristorganization:state
concept:country:italy	concept:agentcontrols	concept:personeurope:alessandro_del_piero
concept:company:microsoft	concept:companyeconomicsector	concept:economicsector:gaming
concept:terroristorganization:state	concept:agentcontrols	concept:weapon:laboratory
concept:vehicle:services	concept:subpartof	concept:programminglanguage:state
concept:politician:jobs	concept:agentcontrols	concept:company:microsoft
concept:buildingfeature:service	concept:subpartof	concept:visualizableattribute:quality_water
concept:sportsteam:morehouse_maroon_tigers	concept:subpartoforganization	concept:sportsteam:ncaa_youth_kids
concept:politician:jobs	concept:worksfor	concept:company:imac
concept:personus:paul_allen	concept:agentcollaborateswithagent	concept:biotechcompany:microsoft_corp
concept:company:acer	concept:subpartoforganization	concept:biotechcompany:gateway_2000
concept:person:chen	concept:topmemberoforganization	concept:website:youtube_last_year
concept:writer:brian_billick	concept:worksfor	concept:sportsteam:ravens
concept:personnorthamerica:john_mccain	concept:agentcollaborateswithagent	concept:politician:obama
concept:city:georgetown	concept:subpartoforganization	concept:sportsteam:ncaa_youth_kids
concept:website:netscape	concept:organizationterminatedperson	concept:scientist:marc_andreessen
concept:coach:dungy	concept:worksfor	concept:sportsteam:buccaneers
concept:buildingfeature:systems	concept:subpartof	concept:visualizableattribute:rural_water
concept:sportsteam:rutgers_scarlet_knights	concept:agentcollaborateswithagent	concept:personmexico:ncaa
concept:university:uga	concept:organizationhiredperson	concept:coach:mark_richt
concept:city:encinitas	concept:subpartof	concept:stateorprovince:california
concept:buildingfeature:systems	concept:subpartof	concept:visualizableattribute:proper_water
concept:newspaper:lafayette	concept:subpartof	concept:musicsong:louisiana
concept:politicianus:mike_krzyzewski	concept:subpartof	concept:geopoliticallocation:duke
concept:sportsteam:knicks	concept:organizationhiredperson	concept:personmexico:bernard_robinson
concept:sportsteam:capitals	concept:organizationhiredperson	concept:coach:glen_hanlon
concept:televisionstation:koti	concept:subpartoforganization	concept:televisionnetwork:nbc_universal
concept:politician:jobs	concept:agentcontrols	concept:personus:warren_buffet
concept:blog:bill_o_reilly	concept:subpartof	concept:mountain:fox
concept:coach:new	concept:subpartof	concept:traditionalgame:vegas
concept:company:nbc	concept:agentcontrols	concept:televisionstation:kbjr_tv
concept:sportsteam:montana_grizzlies	concept:agentcollaborateswithagent	concept:personmexico:ncaa
concept:blog:myspace	concept:companyeconomicsector	concept:economicsector:internet
concept:sportsteam:rutgers	concept:organizationhiredperson	concept:coach:greg_schiano
concept:city:service	concept:agentcontrols	concept:website:jobs
concept:profession:division	concept:subpartof	concept:weatherphenomenon:water
concept:sportsteam:lsu	concept:organizationhiredperson	concept:athlete:john_brady
concept:governmentorganization:courts	concept:organizationhiredperson	concept:personmexico:ryan_whitney
concept:company:intel	concept:organizationheadquarteredincity	concept:city:seattle
concept:sportsteam:lsu	concept:subpartoforganization	concept:sportsteam:ncaa_youth_kids
concept:governmentorganization:national_security_council	concept:organizationhiredperson	concept:personmexico:ryan_whitney
concept:politician:obama	concept:agentcollaborateswithagent	concept:personus:tiger_woods
concept:coach:new	concept:subpartof	concept:county:manhattan
concept:company:oracle	concept:agentcollaborateswithagent	concept:person:larry_ellison
concept:stateorprovince:virginia	concept:organizationhiredperson	concept:coach:al_groh
concept:stateorprovince:wisconsin	concept:organizationhiredperson	concept:coach:brett_lee
concept:coach:randy_shannon	concept:worksfor	concept:county:miami
concept:sportsteam:lsu	concept:organizationhiredperson	concept:coach:les_miles
concept:company:nbc	concept:agentcollaborateswithagent	concept:journalist:chet_huntley
concept:personmexico:ryan_whitney	concept:worksfor	concept:musicartist:allies
concept:politician:clinton	concept:agentcollaborateswithagent	concept:politicianus:barack
concept:coach:pat_dye	concept:agentbelongstoorganization	concept:stateorprovince:auburn
concept:city:band	concept:agentcollaborateswithagent	concept:person:john003
concept:room:offices	concept:subpartof	concept:weatherphenomenon:water
concept:televisionstation:wjfw_tv	concept:subpartof	concept:retailstore:nbc
concept:politicianus:george_w_bush	concept:agentbelongstoorganization	concept:politicalparty:house
concept:university:wozniak	concept:agentbelongstoorganization	concept:biotechcompany:apple
concept:personmexico:ncaa	concept:agentcontrols	concept:sportsteam:wichita_state_shockers
concept:city:normal	concept:subpartof	concept:stateorprovince:illinois
concept:website:rss	concept:organizationheadquarteredincity	concept:city:nagpur
concept:wallitem:works	concept:subpartof	concept:weatherphenomenon:water
concept:personmexico:ncaa	concept:agentcontrols	concept:sportsteam:florida_gulf_coast_eagles
concept:nongovorganization:information	concept:organizationhiredperson	concept:personmexico:ryan_whitney
concept:company:nbc	concept:agentcontrols	concept:televisionstation:wect_tv
concept:person:mccain	concept:agentcollaborateswithagent	concept:politicianus:barack
concept:university:auburn	concept:organizationhiredperson	concept:coach:gene_chizik
concept:sportsleague:syracuse	concept:organizationhiredperson	concept:coach:boeheim
concept:magazine:charlotte	concept:subpartof	concept:company:north_carolina
concept:sportsteam:ncaa_youth_kids	concept:agentcontrols	concept:coach:arkansas_razorbacks
concept:city:home	concept:subpartoforganization	concept:terroristorganization:state
concept:city:challenge	concept:subpartof	concept:weatherphenomenon:water
concept:sportsteam:pittsburgh_panthers	concept:subpartoforganization	concept:sportsteam:ncaa_youth_kids
concept:buildingfeature:systems	concept:subpartof	concept:beverage:integrated_water
concept:televisionstation:king_tv	concept:subpartof	concept:retailstore:nbc
concept:website:koki_tv	concept:subpartof	concept:mountain:fox
concept:terroristorganization:state	concept:agentcontrols	concept:politicsissue:efforts
concept:terroristorganization:state	concept:agentcontrols	concept:televisionshow:confederate_money
concept:personmexico:ncaa	concept:agentcontrols	concept:sportsteam:emory_eagles
concept:city:porterville	concept:subpartof	concept:stateorprovince:california
concept:politicianus:hillary_clinton	concept:agentcollaborateswithagent	concept:person:mccain
concept:coach:lovie_smith	concept:worksfor	concept:county:chicago
concept:sportsteam:hokies	concept:organizationhiredperson	concept:coach:frank_beamer
concept:company:los_angeles	concept:companyeconomicsector	concept:economicsector:insurance
concept:university:purdue	concept:organizationhiredperson	concept:coach:joe_tiller
concept:company:placeware	concept:subpartoforganization	concept:university:microsoft
concept:website:trip	concept:subpartof	concept:weatherphenomenon:water
concept:city:london_city	concept:organizationhiredperson	concept:politician:boris_johnson
concept:country:saudis	concept:organizationhiredperson	concept:personmexico:ryan_whitney
concept:university:nebraska	concept:organizationhiredperson	concept:coach:bob_devaney
concept:sportsteam:falcons	concept:organizationhiredperson	concept:coach:dan_reeves
concept:person:bill	concept:topmemberoforganization	concept:biotechcompany:microsoft_corp
concept:company:gates	concept:agentcollaborateswithagent	concept:company:microsoft
concept:country:mexico	concept:agentbelongstoorganization	concept:sportsleague:mls
concept:coach:clemson	concept:agentcollaborateswithagent	concept:coach:dabo_swinney
concept:sportsteam:ohio_state_university	concept:subpartoforganization	concept:sportsteam:ncaa_youth_kids
concept:politician:obama	concept:agentcollaborateswithagent	concept:person:miley_cyrus
concept:sportsteam:san_diego_padres	concept:organizationhiredperson	concept:coach:chuck_long
concept:hallwayitem:areas	concept:subpartof	concept:website:blood
concept:person:riley001	concept:worksfor	concept:sportsteam:sd_chargers
concept:newspaper:kgw_tv	concept:agentcollaborateswithagent	concept:company:nbc
concept:mlalgorithm:solutions	concept:subpartof	concept:politicsissue:innovative_water
concept:musicartist:times	concept:agentcollaborateswithagent	concept:journalist:bob_herbert
concept:programminglanguage:services	concept:subpartof	concept:beverage:professional_water
concept:televisionstation:kcfw_tv	concept:subpartof	concept:retailstore:nbc
concept:televisionstation:wmaq	concept:subpartoforganization	concept:televisionnetwork:nbc_universal
concept:musicartist:journal	concept:agentcontrols	concept:politicianus:forbes
concept:city:tampa_bay	concept:agentcontrols	concept:charactertrait:dungy
concept:plant:palm	concept:subpartof	concept:traditionalgame:vegas
concept:televisionstation:king_tv	concept:televisionstationaffiliatedwith	concept:televisionnetwork:nbc_universal
concept:sportsteam:cavs	concept:organizationhiredperson	concept:writer:brown
concept:sportsteam:maryland	concept:subpartoforganization	concept:sportsteam:ncaa_youth_kids
concept:sportsteam:tampa_bay_lightning	concept:organizationhiredperson	concept:coach:barry_melrose
concept:bedroomitem:new	concept:subpartof	concept:book:things
concept:sportsteam:missouri_state_bears	concept:subpartoforganization	concept:sportsteam:ncaa_youth_kids
concept:city:washington_d_c	concept:organizationhiredperson	concept:politician:adrian_fenty
concept:blog:google	concept:acquired	concept:website:panoramio
concept:terroristorganization:state	concept:agentcontrols	concept:website:boards
concept:city:lodi	concept:subpartof	concept:stateorprovince:california
concept:person:ron_meyer	concept:topmemberoforganization	concept:company:universal_studios
concept:building:town	concept:subpartof	concept:traditionalgame:vegas
concept:county:high_school	concept:agentcontrols	concept:automobilemodel:jim
concept:sportsleague:mlb	concept:agentcontrols	concept:personmexico:scott_kazmir
concept:sportsteam:maryland	concept:organizationhiredperson	concept:coach:ralph_friedgen
concept:director:committee	concept:subpartof	concept:weatherphenomenon:water
concept:coach:new	concept:subpartof	concept:island:polynesia
concept:geopoliticalorganization:e_mail	concept:subpartoforganization	concept:blog:form
concept:sportsteam:new_york_mets	concept:organizationhiredperson	concept:personus:willie_randolph
concept:governmentorganization:government	concept:agentcontrols	concept:clothing:sites
concept:governmentorganization:action	concept:organizationhiredperson	concept:personmexico:ryan_whitney
concept:island:proposal	concept:subpartof	concept:weatherphenomenon:water
concept:weapon:case	concept:subpartof	concept:mldataset:aol
concept:governmentorganization:cabinet	concept:organizationhiredperson	concept:personmexico:ryan_whitney
concept:vehicle:states	concept:subpartof	concept:lake:great_lakes
concept:buildingfeature:systems	concept:subpartof	concept:visualizableattribute:grey_water
concept:musicalbum:today	concept:subpartof	concept:weatherphenomenon:air
concept:stateorprovince:west_virginia	concept:organizationhiredperson	concept:person:rodriguez
concept:room:family	concept:subpartof	concept:weatherphenomenon:air
concept:bank:viacom	concept:acquired	concept:company:nickelodeon
concept:buildingfeature:systems	concept:subpartof	concept:beverage:poor_water
concept:musicinstrument:buffalo	concept:subpartof	concept:company:new_york
concept:university:villanova	concept:organizationhiredperson	concept:coach:jamey_wright
concept:televisionstation:ktuu	concept:organizationheadquarteredincity	concept:city:anchorage
concept:politician:jobs	concept:agentcontrols	concept:product:appletv
concept:landscapefeatures:sites	concept:subpartof	concept:weatherphenomenon:water
concept:sportsteam:indiana_pacers	concept:organizationhiredperson	concept:athlete:matt_walker
concept:sportsteam:spurs	concept:organizationhiredperson	concept:personaustralia:martin_jol
concept:city:tallinn	concept:subpartof	concept:country:estonia
concept:country:honduras	concept:agentbelongstoorganization	concept:sportsleague:mls
concept:televisionnetwork:cbs	concept:agentcontrols	concept:televisionstation:kyw
concept:city:danville	concept:subpartof	concept:stateorprovince:california
concept:academicfield:lubbock	concept:subpartof	concept:city:texas
concept:city:perth	concept:subpartof	concept:country:australia
concept:stateorprovince:men	concept:organizationterminatedperson	concept:scientist:no_
concept:governmentorganization:energy_department	concept:organizationhiredperson	concept:personmexico:ryan_whitney
concept:sportsteam:southern_mississippi_golden_eagles	concept:subpartoforganization	concept:sportsteam:ncaa_youth_kids
concept:country:syria	concept:organizationhiredperson	concept:personmexico:ryan_whitney
concept:radiostation:logan	concept:subpartof	concept:county:utah
concept:female:yankees	concept:agentcollaborateswithagent	concept:person:gary_sheffield
concept:politician:sites	concept:agentbelongstoorganization	concept:terroristorganization:state
concept:female:reno	concept:subpartof	concept:radiostation:nevada
concept:city:davidson	concept:organizationhiredperson	concept:coach:mckillop
concept:person:sherman	concept:worksfor	concept:automobilemaker:a_m
concept:vehicle:states	concept:subpartof	concept:geopoliticallocation:southwest001
concept:city:ventura	concept:subpartof	concept:stateorprovince:california
concept:automobilemaker:china	concept:organizationhiredperson	concept:personmexico:ryan_whitney
concept:weapon:requirements	concept:subpartof	concept:room:space
concept:company:nbc	concept:agentcontrols	concept:website:wesh_tv
concept:company:nbc	concept:agentcontrols	concept:website:wtov_tv
concept:city:waterbury	concept:subpartof	concept:stateorprovince:connecticut
concept:ceo:sam_zell	concept:agentcontrols	concept:televisionshow:tribune
concept:comedian:estonia	concept:agentcontrols	concept:person:toomas_hendrik_ilves
concept:city:denver	concept:subpartof	concept:sport:heating_and_air
concept:newspaper:record	concept:organizationhiredperson	concept:personmexico:ryan_whitney
concept:sportsteam:notre_dame	concept:organizationhiredperson	concept:personnorthamerica:frank_leahy
concept:visualartmovement:rome	concept:subpartof	concept:country:italy
concept:company:chrysler	concept:companyeconomicsector	concept:economicsector:auto
concept:person:wife001	concept:agentbelongstoorganization	concept:recordlabel:friends
concept:city:san_mateo	concept:subpartof	concept:stateorprovince:california
concept:actor:scott_mcnealy	concept:subpartof	concept:weatherphenomenon:sun
concept:hobby:tap	concept:subpartof	concept:weatherphenomenon:water
concept:vehicle:states	concept:subpartof	concept:weapon:soviet_union
concept:city:area	concept:subpartof	concept:weatherphenomenon:winter
concept:vehicle:states	concept:subpartof	concept:profession:atlantic
concept:hobby:studio	concept:subpartof	concept:weatherphenomenon:air
concept:radiostation:boise	concept:subpartof	concept:newspaper:idaho
concept:hallwayitem:van	concept:subpartof	concept:hallwayitem:air
concept:city:denver	concept:organizationhiredperson	concept:politician:wellington_webb
concept:city:columbia	concept:subpartof	concept:stateorprovince:south_carolina
concept:coach:new	concept:subpartof	concept:sportsgame:more_weeks
concept:county:new_mexico	concept:organizationhiredperson	concept:coach:mike_locksley
concept:profession:camden	concept:subpartof	concept:bridge:new_jersey
concept:city:loveland	concept:subpartof	concept:stateorprovince:colorado
concept:book:network	concept:subpartof	concept:musicalbum:power
concept:county:tracy	concept:subpartof	concept:stateorprovince:california
concept:company:admob	concept:companyeconomicsector	concept:economicsector:advertising
concept:company:nbc	concept:agentcollaborateswithagent	concept:journalist:david_gregory
concept:university:clemson	concept:organizationhiredperson	concept:coach:danny_ford
concept:city:hopkinsville	concept:subpartof	concept:stateorprovince:kentucky
concept:female:yankees	concept:agentcollaborateswithagent	concept:personaustralia:mark_teixeira
concept:hallwayitem:boat	concept:subpartof	concept:hallwayitem:air
concept:buildingfeature:sections	concept:subpartof	concept:weatherphenomenon:water
